dyspeptic: A dyspeptic person.
whorl: A pattern of concentric circles.
stratum: One of several parallel horizontal layers of material arranged one on top of another.
opine: To have or express an opinion; to state as an opinion; to suppose, consider (that).
plumb: A little mass of lead, or the like, attached to a line, and used by builders, etc., to indicate a vertical direction.
brawl: A disorderly argument or fight, usually with a large number of people involved.
depreciate: To lessen in price or estimated value; to lower the worth of.
implicate: The thing implied.
urban: Related to the (or any) city.
bequest: The act of bequeathing or leaving by will.
ubiquitous: Being everywhere at once: omnipresent.
furtive: Stealthy.
abandoned: To give up or relinquish control of, to surrender or to give oneself over, or to yield to one's emotions.
contend: To strive in opposition; to contest; to dispute; to vie; to quarrel; to fight.
herculean: Of extraordinary might, power, size, etc.; suggesting Hercules in size or strength.
welt: To roll; revolve
discomfit: To defeat completely; to rout.
prude: A person who is or tries to be excessively proper, especially one who is easily offended by matters of a sexual nature.
fetid: The foul-smelling asafoetida plant, or its extracts.
iconoclast: One who destroys religious images or icons, especially an opponent of the Orthodox Church in the 8th and 9th centuries, or a Puritan during the European Reformation.
conscientious: Thorough, careful, or vigilant in one’s task performance.
reticent: Keeping one's thoughts and opinions to oneself; reserved or restrained.
derogatory: A trade-line on a credit report that includes negative credit history.
filigree: A delicate and intricate ornamentation made from gold or silver (or sometimes other metal) twisted wire.
improvement: The act of improving; advancement or growth; a bettering
urgency: The quality or condition of being urgent
beset: To surround or hem in.
futile: Incapable of producing results; doomed not to be successful; not worth attempting.
umbrage: A feeling of anger or annoyance caused by something offensive.
absolutely: In an absolute or unconditional manner; utterly, positively, wholly.
stake: A piece of wood or other material, usually long and slender, pointed at one end so as to be easily driven into the ground as a marker or a support or stay.
burgeon: A bud, sprout, shoot.
wreak: To cause something harmful; to afflict; to inflict; to harm or injury; to let out something harmful; .
dispel: An act or instance of dispelling.
luminary: One who is an inspiration to others; one who has achieved success in their chosen field; a leading light.
saturnine: Of a person: having a tendency to be cold, bitter, gloomy, sarcastic, and slow to change and react.
arbitrary: Anything arbitrary, such as an arithmetical value or a fee.
propensity: An inclination, disposition, tendency, preference, or attraction.
abash: To make ashamed; to embarrass; to destroy the self-possession of, as by exciting suddenly a consciousness of guilt, mistake, or inferiority; to disconcert; to discomfit.
desiccate: A substance which has been dessicated, that is, had its moisture removed.
include: A piece of source code or other content that is dynamically retrieved for inclusion in another item.
douse: A sudden plunging into water.
garrulous: Excessively or tiresomely talkative.
utilitarian: Someone who practices or advocates utilitarianism.
crone: An old woman.
tenable: (of a theory, argument, etc.) capable of being maintained or justified; well-founded
disrepute: Loss or want of reputation; ill character.
useless: Without use or possibility to be used.
willful: Intentional; deliberate.
discursive: (of speech or writing) Tending to digress from the main point; rambling.
toil: Labour, work, especially of a grueling nature.
access: A way or means of approaching or entering; an entrance; a passage.
blasphemy: An act of irreverence or contempt toward a god or toward something considered sacred; an impious act, utterance, view, etc.
ominous: Of or pertaining to an omen or to omens; being or exhibiting an omen; significant.
chide: To admonish in blame; to reproach angrily.
abate: Abatement.
despondent: In low spirits from loss of hope or courage.
daft: Foolish, silly, stupid.
prognosticate: To predict or forecast, especially through the application of skill.
genre: A kind; a stylistic category or sort, especially of literature or other artworks.
veracity: (of a person) The quality of speaking or stating the truth; truthfulness.
verdant: Green in colour.
inimitable: Beyond imitation, surpassing all others, matchless.
informative: Providing information; especially, providing useful or interesting information.
divisive: Having a quality that divides or separates
zealot: One who is zealous, one who is full of zeal for his own specific beliefs or objectives, usually in the negative sense of being too passionate; a fanatic
dais: A raised platform in a room for a high table, a seat of honour, a throne, or other dignified occupancy; a similar platform supporting a lectern, pulpit, etc., which may be used to speak from.
perish: To decay and disappear; to waste away to nothing.
edifice: A building; a structure; an architectural fabric, especially a large and spectacular one
acknowledge: To admit the knowledge of; to recognize as a fact or truth; to declare one's belief in
raiment: Clothing, garments, dress, material.
blatant: Bellowing; disagreeably clamorous; sounding loudly and harshly.
abdicate: To disclaim and expel from the family, as a father his child; to disown; to disinherit.
despot: A ruler with absolute power; a tyrant.
lout: A troublemaker, often violent; a rude violent person; a yob.
vulpine: Any of certain canids called foxes (including the true foxes, the arctic fox and the grey fox); distinguished from the canines, which are regarded as similar to the dog and wolf.
genteel: Affectedly proper or refined; somewhat prudish refinement; excessively polite.
vicissitude: Regular change or succession from one thing to another, or one part of a cycle to the next; alternation; mutual succession; interchange.
vessel: Any craft designed for transportation on water, such as a ship or boat.
insane: Exhibiting unsoundness or disorder of mind; not sane; mad
depredation: An act of consuming agricultural resources (crops, livestock), especially as plunder.
dour: Stern, harsh and forbidding.
moribund: A person who is near to dying.
pervade: To be in every part of; to spread through.
automate: To replace or enhance human labor with machines.
intrepid: Fearless; bold; brave.
actually: (modal) In act or in fact; really; in truth; positively.
disposition: The arrangement or placement of certain things.
simper: A foolish, frivolous, self-conscious, or affected smile; a smirk.
aberration: The act of wandering; deviation from truth, moral rectitude; abnormal; divergence from the straight, correct, proper, normal, or from the natural state.
blithe: (dated or literary) Happy, cheerful.
destitute: (followed by the preposition "of") Lacking something; devoid
vituperate: To criticize in a harsh or abusive manner.
wary: Cautious of danger; carefully watching and guarding against deception, trickery, and dangers; suspiciously prudent
pluck: An instance of plucking.
gesticulate: To make gestures or motions, as in speaking.
insolent: A person who is insolent.
amalgamate: To merge, to combine, to blend, to join.
modicum: A modest, small, or trifling amount.
duress: Harsh treatment.
gusto: Enthusiasm; enjoyment, vigor.
foster: A foster parent.
seemly: (of behavior) Appropriate; suited to the occasion or purpose; becoming.
adjusted: To modify.
iniquitous: Wicked or sinful
rail: A horizontal bar extending between supports and used for support or as a barrier; a railing.
winsome: Charming, engaging, winning; inspiring approval and trust, especially if in an innocent manner.
bedlam: A place or situation of chaotic uproar, and where confusion prevails.
abhor: To regard with horror or detestation; to shrink back with shuddering from; to feel excessive repugnance toward; to detest to extremity; to loathe.
weary: To make or to become weary.
desultory: Jumping, or passing, from one thing or subject to another, without order, planning, or rational connection; lacking logical sequence.
immutable: Something that cannot be changed
glut: An excess, too much.
insurance: A means of indemnity against a future occurrence of an uncertain event.
bovine: An animal of the family, subfamily, tribe, or genera including cattle, buffaloes and bison.
connotation: A meaning of a word or phrase that is suggested or implied, as opposed to a denotation, or literal meaning. A characteristic of words or phrases, or of the contexts that words and phrases are used in.
elegy: A mournful or plaintive poem; a funeral song; a poem of lamentation.
repeal: An act or instance of repealing.
bouillon: A clear seasoned broth made by simmering usually light meat, such as beef or chicken.
fitful: Irregular; unsteady; characterized by fits.
advantage: Any condition, circumstance, opportunity or means, particularly favorable to success, or to any desired end.
sentient: Lifeform with the capability to feel sensation, such as pain.
cardinal: One of the officials appointed by the pope in the Roman Catholic Church, ranking only below the pope and the patriarchs, constituting the special college which elects the pope. (See Wikipedia article on Catholic cardinals.)
yoke: Frame around the neck, and related senses.
grueling: (racing) A race in which the animal being raced finishes in a state of physical exhaustion.
abject: A person in the lowest and most despicable condition; a castaway; outcast.
grandiloquent: (of a person, their language or writing) given to using language in a showy way by using an excessive amount of difficult words to impress others; bombastic; turgid
dialectical: Of, or pertaining to dialectic; logically reasoned through the exchange of opposing ideas.
weigh: To determine the weight of an object.
brevity: The quality of being brief in duration.
proxy: An agent or substitute authorized to act for another person.
adventitious: From an external source; not innate or inherent, foreign.
embezzlement: The fraudulent conversion of property from a property owner.
intelligent: Of high or especially quick cognitive capacity, bright.
omniscient: One who has total knowledge.
retiring: To stop working on a permanent basis, usually because of old age or illness.
erode: To wear away by abrasion, corrosion or chemical reaction.
garish: Overly ostentatious; so colourful as to be in bad taste.
affect: To influence or alter.
abnegate: To deny (oneself something); to renounce or give up (a right, a power, a claim, a privilege, a convenience).
encumber: To load down something with a burden
wily: Sly, cunning, full of tricks
grandiose: Large and impressive, in size, scope or extent
boast: A brag; ostentatious positive appraisal of oneself.
weird: Fate; destiny; luck.
dictum: An authoritative statement; a dogmatic saying; a maxim, an apothegm.
broach: A series of chisel points mounted on one piece of steel. For example, the toothed stone chisel shown here.
dote: A darling, a cutie.
emollient: Something which softens or lubricates the skin; moisturizer.
recondite: A recondite (hidden or obscure) person or thing.
apostate: A person who has renounced a religion or faith.
intention: The goal or purpose behind a specific action or set of actions.
unaffected: (very rare) To not affect.
readjustment: A second, or subsequent adjustment
incidental: Minor items, not further defined. Incidental expense.
agency: The capacity, condition, or state of acting or of exerting power.
baleful: Portending evil; ominous.
tirade: A long, angry or violent speech; a diatribe.
abortive: That which is born or brought forth prematurely; an abortion.
gratuitous: Given freely; unearned.
wholly: Completely and entirely; to the fullest extent.
burlesque: A derisive art form that mocks by imitation; a parody.
reactionary: One who is opposed to change.
advocate: Someone whose job is to speak for someone's case in a court of law; a counsel.
didactic: A treatise on teaching or education.
epistolary: A Christian liturgical book containing set readings for church services from the New Testament Epistles.
zephyr: A light wind from the west.
carrion: Dead flesh; carcasses.
jeopardy: Danger of loss, harm, or failure.
canto: One of the chief divisions of a long poem; a book.
erstwhile: Former, previous.
slew: The act, or process of slewing.
alien: Any life form of extraterrestrial or extradimensional origin.
quaff: The act of quaffing; a deep draught.
wonderful: Tending to excite wonder; surprising, extraordinary.
abridge: To deprive; to cut off.
gravity: The state or condition of having weight; weight; heaviness.
cacophony: A mix of discordant sounds; dissonance.
diffident: Lacking confidence in others; distrustful.
evince: To show or demonstrate clearly; to manifest.
rationalism: The theory that the reason is a source of knowledge independent of and superior to sense perception.
bestow: To lay up in store; deposit for safe keeping; to stow or place; to put something somewhere.
countermand: An order to the contrary of a previous one.
emolument: Payment for an office or employment; compensation for a job, which is usually monetary.
aquiline: Of, pertaining to, or characteristic of eagles; resembling that of an eagle.
patronize: To act as a patron of; to defend, protect, or support.
usurp: To seize power from another, usually by illegitimate means.
jettison: (collective) Items that have been or are about to be ejected from a boat or balloon.
amuse: To entertain or occupy in a pleasant manner; to stir with pleasing emotions.
gregarious: (of a person) Describing one who enjoys being in crowds and socializing.
paean: A chant or song, especially a hymn of thanksgiving for deliverance or victory, to Apollo or sometimes another god or goddess; hence any song sung to solicit victory in battle.
violence: Extreme force.
absolute: That which is independent of context-dependent interpretation, inviolate, fundamental.
captious: That captures; especially, (of an argument, words etc.) designed to capture or entrap in misleading arguments; sophistical.
endue: To pass food into the stomach; to digest; also figuratively, to take on, absorb.
digress: To step or turn aside; to deviate; to swerve; especially, to turn aside from the main subject of attention, or course of argument, in writing or speaking.
exigent: Extremity; end; limit; pressing urgency.
cadence: The act or state of declining or sinking.
impiety: The state of being impious.
notwithstanding: An instance of the word "notwithstanding", often characteristic of legalese.
bilious: Of or pertaining to something containing or consisting of bile.
refulgent: Resplendent, or shining brightly and radiantly.
guile: Astuteness often marked by a certain sense of cunning or artful deception.
expunge: To erase or strike out.
decadence: A state of moral or artistic decline or deterioration; decay
cajole: To persuade someone to do something which they are reluctant to do, especially by flattery or promises; to coax.
teem: To be stocked to overflowing.
cognate: One of a number of things allied in origin or nature.
annual: An annual publication; a book, periodical, journal, report, comic book, yearbook, etc., which is published serially once a year, which may or may not be in addition to regular weekly or monthly publication.
dilettante: An amateur, someone who dabbles in a field out of casual interest rather than as a profession or serious interest.
lofty: High, tall, having great height or stature
vision: The sense or ability of sight.
sentinel: A sentry, watch, or guard.
absolve: To set free, release or discharge (from obligations, debts, responsibility etc.).
discriminating: To make distinctions.
journey: A set amount of travelling, seen as a single unit; a discrete trip, a voyage.
vilify: To say defamatory things about someone or something; to speak ill of.
facetious: Treating serious issues with (often deliberately) inappropriate humour; flippant.
hackneyed: To make uninteresting or trite by frequent use.
extant: Still in existence.
estrange: To cause to feel less close or friendly; alienate. To cease contact with (particularly of a family member or spouse, especially in form estranged).
barely: (degree) By a small margin.
forebear: To keep away from; to avoid; to abstain from.
avocation: A calling away; a diversion.
discern: To detect with the senses, especially with the eyes.
voyage: A long journey, especially by ship.
multitude: A great amount or number, often of people; abundance, myriad, profusion.
callow: A callow young bird.
brooch: A piece of women’s ornamental jewellery having a pin allowing it to be fixed to garments worn on the upper body.
precision: The state of being precise or exact; exactness.
kiosk: A small enclosed structure, often freestanding, open on one side or with a window, used as a booth to sell newspapers, cigarettes, etc.
abstinent: Refraining from indulgence, especially from the indulgence of appetite.
nuance: A minor distinction.
expurgate: To edit out (incorrect, offensive, or otherwise undesirable information) from a book or other publication; to cleanse; to purge.
cadaverous: Corpselike; hinting of death; imitating a cadaver.
allay: Alleviation; abatement; check.
harbinger: A person or thing that foreshadows or foretells the coming of someone or something.
discreet: Respectful of privacy or secrecy; exercising caution in order to avoid causing embarrassment; quiet; diplomatic.
syllogism: An argument whose conclusion is supported by two premises, of which one contains the term that is the predicate of the conclusion, and the other contains the term that is the subject of the conclusion; common to both premises is a term that is excluded from the conclusion.
candor: Whiteness; brilliance; purity.
spat: To evacuate (saliva or another substance) from the mouth, etc.
benefit: An advantage; help or aid from something.
depose: To put down; to lay down; to deposit; to lay aside; to put away.
yearn: To long, have a strong desire (for something).
pert: An impudent person.
steep: The steep side of a mountain etc.; a slope or acclivity.
gawk: A cuckoo.
fallacious: Characterized by fallacy; false or mistaken.
abstract: An abridgement or summary of a longer publication.
league: A group or association of cooperating members.
foist: A thief or pickpocket.
hedonism: The belief that pleasure or happiness is the highest good in life. Some hedonists, such as the Epicureans, have insisted that pleasure of the entire mind, not just pleasure of the senses, is the highest good.
discrete: Separate; distinct; individual; non-continuous.
cogent: Reasonable and convincing; based on evidence.
collation: Bringing together.
capricious: Impulsive and unpredictable; determined by chance, impulse, or whim
bough: A firm branch of a tree.
warble: The sound of one who warbles; singing with trills or modulations.
precept: A rule or principle, especially one governing personal conduct.
refectory: A dining-hall, especially in an institution such as a college or monastery.
disembark: To remove from on board a vessel; to put on shore
forbearance: Patient self-control; restraint and tolerance under provocation.
heed: Careful attention.
abstruse: Difficult to comprehend or understand.
caricature: A pictorial representation of someone in which distinguishing features are exaggerated for comic effect.
scintillate: To give off sparks; to shine as if emanating sparks; to twinkle or glow.
dotage: Decline in judgment and other cognitive functions, associated with aging; senility.
heresy: A doctrine held by a member of a religion at variance with established religious beliefs, especially dissension from Roman Catholic dogma.
yield: To pay, give in payment; repay, recompense; reward; requite.
disdain: A feeling of contempt or scorn.
boulder: A large mass of stone detached from the surrounding land.
haggle: To argue for a better deal, especially over prices with a seller.
lightning: A flash of light produced by short-duration, high-voltage discharge of electricity within a cloud, between clouds, or between a cloud and the earth.
mien: Demeanor; facial expression or attitude, especially one which is intended by its bearer.
palatial: Of or relating to a palace.
fray: To (cause to) unravel; used particularly for the edge of something made of cloth, or the end of a rope.
gourmand: A person given to excess in the consumption of food and drink; a greedy or ravenous eater.
aria: A musical piece written typically for a solo voice with orchestral accompaniment in an opera or cantata.
abysmal: Pertaining to, or resembling an abyss.
madrigal: A song for a small number of unaccompanied voices; from 13th century Italy.
hermetic: (chiefly with capital initial) Pertaining to Hermes Trismegistus or the writings attributed to him.
disinterested: Having no stake or interest in the outcome; free of bias, impartial.
waylay: To lie in wait for and attack from ambush.
castigate: To punish or reprimand someone severely.
nexus: A form of connection.
modest: Not bragging or boasting about oneself or one's achievements; unpretentious, humble.
boundary: The dividing line or location between two areas.
litany: A ritual liturgical prayer in which a series of prayers recited by a leader are alternated with responses from the congregation.
zenith: The point in the sky vertically above a given position or observer; the point in the celestial sphere opposite the nadir.
sate: To satisfy the appetite or desire of; to fill up.
mincing: To make less; make small.
candid: A spontaneous or unposed photograph.
hapless: Very unlucky; ill-fated.
trappings: Clothing or equipment; that which gives the appearance of something.
accolade: An expression of approval; praise.
philistine: A person who is ignorant or uneducated; specifically, a person who lacks appreciation of or is antagonistic towards art or culture, and who has pedestrian tastes.
heyday: A period of success, popularity, or power; prime.
savant: A person of learning, especially one who is versed in literature or science.
catalyst: A substance that increases the rate of a chemical reaction without being consumed in the process.
constituency: A district represented by one or more elected officials.
zoology: The part of biology relating to the animal kingdom, including the structure, embryology, evolution, classification, habits, and distribution of all animals, both living and extinct.
literacy: The ability to read and write.
disparage: Inequality in marriage; marriage with an inferior.
trenchant: Fitted to trench or cut; gutting; sharp.
bucolic: Rustic, pastoral, country-styled.
brake: A fern; bracken.
partial: A partial derivative: a derivative with respect to one independent variable of a function in multiple variables while holding the other variables constant.
enduring: To continue or carry on, despite obstacles or hardships; to persist.
glib: To make glib.
votary: A person, such as a monk or nun, who lives a religious life according to vows they have made
accost: Address; greeting.
hiatus: A gap in a series, making it incomplete.
cohort: A group of people supporting the same thing or person.
catharsis: A release of emotional tension after an overwhelming vicarious experience, resulting in the purging or purification of the emotions, as through watching a dramatic production (especially a tragedy).
patrician: (antiquity) A member of any of the families constituting the populus Romanus, or body of Roman citizens, before the development of the plebeian order; later, one who, by right of birth or by special privilege conferred, belonged to the senior class of Romans, who, with certain property, had by right a seat in the Roman Senate.
tepid: Lukewarm; neither warm nor cool.
idiosyncratic: Peculiar to a specific individual; eccentric.
denouement: (authorship, often used metaphorically) The conclusion or resolution of a plot.
emboss: To mark or decorate with a raised design or symbol.
disparate: (chiefly in the plural) Any of a group of unequal or dissimilar things.
lunar: The middle bone of the proximal series of the carpus in the wrist, which is shaped like a half-moon.
credible: Believable or plausible.
brethren: Of or akin to; related; like
impertinent: An impertinent individual.
pucker: A fold or wrinkle.
categorical: A categorical proposition.
acerbic: Tasting sour or bitter.
hierarchy: A body of authoritative officials organized in nested ranks.
caustic: Any substance or means which, applied to animal or other organic tissue, burns, corrodes, or destroys it by chemical action; an escharotic.
impecunious: Lacking money
animus: The basic impulses and instincts which govern one's actions.
proletarian: A member of the proletariat.
unction: A salve or ointment.
disseminate: To sow and scatter principles, ideas, opinions, etc, or concrete things, for growth and propagation, like seeds.
provoke: To cause someone to become annoyed or angry.
insinuate: To hint; to suggest tacitly (usually something bad) while avoiding a direct statement.
hostel: A commercial overnight lodging place, with dormitory accommodation and shared facilities, especially a youth hostel
parry: A defensive or deflective action; an act of parrying.
brief: A writ summoning one to answer to any action.
rejoinder: The defendant's answer to the replication.
bland: Having a soothing effect; not irritating or stimulating.
fulsome: Offensive to good taste, tactless, overzealous, excessive.
acquiesce: (with in (or sometimes with, to)) To rest satisfied, or apparently satisfied, or to rest without opposition and discontent (usually implying previous opposition or discontent); to accept or consent by silence or by omitting to object.
histrionic: Of or relating to actors or acting.
censure: The act of blaming, criticizing, or condemning as wrong; reprehension.
impetuous: Making arbitrary decisions, especially in an impulsive and forceful manner.
overweening: Unduly confident; arrogant
sycophant: One who uses obsequious compliments to gain self-serving favor or advantage from another; a servile flatterer.
adjure: To issue a formal command.
dissipate: To drive away, disperse.
rivulet: A small brook or stream; a streamlet.
humorous: Full of humor or arousing laughter; funny.
tread: To step or walk (on or over something); to trample.
practitioner: A person who practices a profession or art, especially law or medicine.
spangle: A small piece of sparkling metallic material sewn on to a garment as decoration; a sequin.
indisposed: Mildly ill.
category: A group, often named or numbered, to which items are assigned based on similarity or defined criteria.
nominal: (grammar) A noun or word group that functions as part of a noun phrase.
homily: A sermon, especially concerning a practical matter.
impinge: To make a physical impact on.
cerebral: Of, or relating to the brain, cerebrum, or cerebral cortex.
sumptuous: Magnificent, luxurious, splendid.
acrid: Sharp and harsh, or bitter and not to the taste.
preen: A forked tool used by clothiers for dressing cloth.
acrimony: A sharp and bitter hatred.
crabbed: To fish for crabs.
ascertain: To find out definitely; to discover or establish.
dissolution: The termination of an organized body or legislative assembly, especially a formal dismissal.
hygiene: The science of health, its promotion and preservation.
ravel: A snarl; a complication.
blighted: To affect with blight; to blast; to prevent the growth and fertility of.
dissemble: To disguise or conceal something.
suppliant: One who pleads or requests earnestly.
celebration: The formal performance of a solemn rite, such as Christian sacrament.
homogeneous: Of the same kind; alike, similar.
largesse: Generosity in the giving of gifts or money.
acrimonious: Harsh and sharp, or bitter and not pleasant to the taste; acrid, pungent.
penchant: Taste, liking, or inclination (for).
distend: To extend or expand, as from internal pressure; to swell
impute: To attribute or ascribe (responsibility or fault) to a cause or source.
importune: To bother, trouble, irritate.
chagrin: Distress of mind caused by a failure of aims or plans, want of appreciation, mistakes etc; vexation or mortification.
infest: Hostility.
nicety: A small detail or distinction.
fare: A going; journey; travel; voyage; course; passage.
clarion: A medieval brass instrument, related to the trumpet, or its sound.
ungainly: An ungainly person or thing.
interrupt: An event that causes a computer or other device to temporarily cease what it was doing and attend to a condition.
languid: Lacking enthusiasm, energy, or strength; drooping or flagging from weakness, fatigue, or lack of energy
character: A being involved in the action of a story.
retentive: That which retains or confines; a restraint.
husbandry: The occupation or work of a husbandman or farmer; the cultivation of crops and the raising of livestock; agriculture.
acumen: Quickness of perception or discernment; penetration of mind; the faculty of nice discrimination.
bauble: A cheap showy ornament piece of jewellery; a gewgaw.
felicitous: Characterized by felicity.
awning: A rooflike cover, usually of canvas, extended over or before any place as a shelter from the sun, rain, or wind.
actuate: To activate, or to put into motion; to animate.
cede: To give up; yield to another.
turbid: (of a liquid) Having the lees or sediment disturbed; not clear.
charlatan: A mountebank, someone who addresses crowds in the street; (especially), an itinerant seller of medicines or drugs.
inane: That which is void or empty.
rave: An enthusiastic review (such as of a play).
docile: Ready to accept instruction or direction; obedient; subservient.
invisible: An invisible person or thing; specifically, God, the Supreme Being.
circuit: The act of moving or revolving around, or as in a circle or orbit; a revolution
unconscionable: Not conscionable; unscrupulous and lacking principles or conscience.
hyperbole: Deliberate or unintentional overstatement, particularly extreme overstatement.
acute: A person who has the acute form of a disorder, such as schizophrenia.
puerile: Childish; trifling; silly.
mountebank: One who sells dubious medicines.
vestment: A robe, gown, or other article of clothing worn as an indication of office.
cupidity: Extreme greed, especially for wealth.
balk: An uncultivated ridge formed in the open field system, caused by the action of ploughing.
demoralize: To destroy the morale of; to dishearten.
inchoate: A beginning, an immature start.
chastise: To punish (someone), especially by corporal punishment.
perpetual: Lasting forever, or for an indefinitely long time
monetary: Of, pertaining to, or consisting of money.
doctrinaire: A person who stubbornly holds to a philosophy or opinion regardless of its feasibility.
irrational: A real number that can not be expressed as the quotient of two integers, an irrational number.
hypothetical: A hypothetical situation or proposition
urbane: (of a man) Courteous, polite, refined, and suave.
adage: An old saying which has obtained credit by long use
odium: Hatred; dislike.
college: A corporate group; a group of colleagues.
disaffected: To cause a loss of affection, sympathy or loyalty in; to alienate or estrange.
simulate: To model, replicate, duplicate the behavior, appearance or properties of.
insensate: One who is insensate.
incontrovertible: Not capable of being denied, challenged, or disputed; closed to questioning.
devolve: To roll (something) down; to unroll.
chicanery: Deception by use of trickery, quibbling, or subterfuge.
fawning: To give birth to a fawn.
decree: An edict or law.
dogmatic: One of an ancient sect of physicians who went by general principles; opposed to the empiric.
headlong: To precipitate.
issue: The action or an instance of flowing or coming out, an outflow, particularly:
spectral: Of, or pertaining to, spectres; ghostly.
minute: A unit of time equal to sixty seconds (one-sixtieth of an hour).
subdue: To overcome, quieten, or bring under control.
adamant: An imaginary rock or mineral of impenetrable hardness; a name given to the diamond and other substances of extreme hardness.
mellifluous: Flowing like honey.
preternatural: Beyond or not conforming to what is natural or according to the regular course of things; strange.
incumbent: The current holder of an office, such as ecclesiastical benefice or an elected office.
sherbet: A food of frozen fruit juice with a dairy product such as milk added; a sorbet with dairy ingredients.
community: A group sharing a common understandingaddress: Direction.
subsume: To place (any one cognition) under another as belonging to it; to include or contain something else.
eschew: To avoid; to shun, to shy away from.
competition: The action of competing.
knowledge: The fact of knowing about something; general understanding or familiarity with a subject, place, situation etc.
rankle: To cause irritation or deep bitterness.
accord: Agreement or concurrence of opinion, will, or action.
contrive: To invent by an exercise of ingenuity; to devise
hummock: A small hill; a hillock; a knoll.
dogma: An authoritative principle, belief or statement of opinion, especially one considered to be absolutely true and indisputable, regardless of evidence or without evidence to support it.
chimera: Alternative letter-case form of Chimera (a flame-spewing monster often represented as having two heads, one of a goat and the other of a lion; the body of a goat; and a serpent as a tail).
beatific: Blessed, blissful, heavenly
infallible: Without fault or weakness; incapable of error or fallacy.
waive: To relinquish (a right etc.); to give up claim to; to forego.
adherent: A person who has membership in some group, association or religion.
gaudy: One of the large beads in the rosary at which the paternoster is recited.
expatiate: To range at large, or without restraint.
majestic: Having qualities of splendor or royalty.
complain: To express feelings of pain, dissatisfaction, or resentment.
elude: To evade, or escape from someone or something, especially by using cunning or skill
evident: Obviously true by simple observation.
derived: To obtain or receive (something) from something else.
discretionary: Available at one's discretion; able to be used as one chooses; left to or regulated by one's own discretion or judgment.
dissonant: Exhibiting dissonance; not agreeing or harmonizing.
choleric: A person with a choleric temperament.
bemuse: To confuse or bewilder.
munificent: (of a person or group) Very liberal in giving or bestowing.
unwonted: Not customary or habitual; unusual; infrequent; strange.
coax: A simpleton; a dupe.
grovel: To be prone on the ground.
admonish: To warn or notify of a fault; to reprove gently or kindly, but seriously; to exhort.
inexorable: Impossible to prevent or stop; inevitable.
sinuous: Having curves in alternate directions; meandering.
complete: A completed survey.
martial: A person under the astrological influence of the planet Mars.
pithy: Concise and meaningful.
stench: A strong foul smell; a stink.
elaborate: To develop in detail or complexity
dormant: A crossbeam or joist.
practice: Repetition of an activity to improve a skill.
microcosm: Human nature or the human body as representative of the wider universe; man considered as a miniature counterpart of divine or universal nature.
chronic: Marijuana, typically of high quality.
scabbard: The sheath of a sword.
seethe: To boil.
explicate: To explain meticulously or in great detail; to elucidate; to analyze.
sprawl: An ungainly sprawling posture.
injunction: The act of enjoining; the act of directing, commanding, or prohibiting.
adroit: Deft, dexterous, or skillful.
rancor: The deepest malignity or spite; deep-seated enmity or malice; inveterate hatred.
concern: That which affects one’s welfare or happiness. A matter of interest to someone. The adposition before the matter of interest is usually over, about or for.
measure: A prescribed quantity or extent.
cachet: A seal, as of a letter.
substantial: Anything having substance; an essential part.
dubious: (of a statement) Arousing doubt; questionable; open to suspicion.
comport: Manner of acting; conduct; deportment.
factitious: Created by humans; artificial.
chronicle: A written account of events and when they happened, ordered by time.
intend: (usually followed by the particle "to") To hope; to wish (something, or something to be accomplished); be intent upon
beleaguer: To besiege; to surround with troops.
scrutinize: To examine something with great care or detail, as to look for hidden or obscure flaws.
whet: The act of whetting something.
gaunt: Lean, angular and bony
inoculate: To introduce an antigenic substance or vaccine into something (e.g. the body) or someone, such as to produce immunity to a specific disease.
puissant: Powerful, mighty, having authority.
adulation: Flattery; fulsome praise.
confidence: Self-assurance.
medicine: A substance which specifically promotes healing when ingested or consumed in some way.
circuitous: Not direct or to the point.
tether: A rope, cable etc. that holds something in place whilst allowing some movement
duplicity: Intentional deceptiveness; double-dealing.
checkered: To mark in a pattern of alternating light and dark positions, like a checkerboard.
gestate: To carry offspring in the uterus from conception to delivery.
gripe: A complaint, often a petty or trivial one.
frontier: The part of a country which borders or faces another country or unsettled region
execrate: To feel loathing for; to abhor
commit: The act of committing (e.g. a database transaction or source code into a source control repository), making it a permanent change.
hone: A sharpening stone composed of extra-fine grit used for removing the burr or curl from the blade of a razor or some other edge tool.
morbid: Of, or relating to disease.
insidious: Producing harm in a stealthy, often gradual, manner.
homespun: Fabric made from homespun yarn. Also, machine made fabrics (usually cottons) similar to homespun fabrics in that solids, plaids, or stripes are created by weaving dyed threads (rather than printing), so that both sides of the fabric look the same.
consider: To think about seriously.
adulterate: To corrupt.
medieval: Someone living in the Middle Ages.
circumlocution: A roundabout or indirect way of speaking; the use of more words than necessary to express an idea.
smattering: A superficial or shallow knowledge of a subject.
ebullient: Enthusiastic; high-spirited.
ambrosia: The food of the gods, thought to confer immortality.
traduce: To malign a person or entity by making malicious and false or defamatory statements.
remission: A pardon of a sin; the forgiveness of an offence, or relinquishment of a (legal) claim or a debt.
cite: To quote; to repeat, as a passage from a book, or the words of another.
implacable: Not able to be placated or appeased.
rider: One who rides, often on a horse or a motorcycle.
approach: The act of drawing near; a coming or advancing near.
difficult: To make difficult; to impede; to perplex.
embroil: To draw into a situation; to cause to be involved.
ranging: To travel over (an area, etc); to roam, wander.
mineral: Any naturally occurring inorganic material that has a (more or less) definite chemical composition and characteristic physical properties.
instigate: To incite; to bring about by urging or encouraging
adverse: Unfavorable; antagonistic in purpose or effect; hostile; actively opposing one's interests or wishes; contrary to one's welfare; acting against; working in an opposing direction.
pulchritude: Physical beauty.
circumscribe: To draw a line around; to encircle.
eccentric: One who does not behave like others.
factious: Of, pertaining to, or caused by factions.
exorbitant: Exceeding proper limits; extravagant; excessive or unduly high.
sextant: A navigational device for deriving angular distances between objects so as to determine latitude and longitude.
warrant: Authorization or certification; a sanction, as given by a superior.
pique: A feeling of enmity; ill-feeling, animosity; a transient feeling of wounded pride.
pacify: To bring peace to (a place or situation), by ending war, fighting, violence, anger or agitation.
brook: To use; enjoy; have the full employment of.
establish: To make stable or firm; to confirm.
pathological: Pertaining to pathology.
area: A measure of the extent of a surface; it is measured in square units.
molecule: The smallest particle of a specific element or compound that retains the chemical properties of that element or compound; two or more atoms held together by chemical bonds.
interlocutor: A person who takes part in dialogue or conversation.
aesthetic: The study of art or beauty.
ordeal: A painful or trying experience.
circumspect: Carefully aware of all circumstances; considerate of all that is pertinent.
eclectic: Someone who selects according to the eclectic method.
invocation: The act or form of calling for the assistance or presence of some superior being, especially prayer offered to a divine being.
disgorge: To vomit or spew, to discharge.
coiffure: Hairstyle
dense: A thicket.
mite: Any of many minute arachnids which, along with the ticks, comprise subclass Acarina (aka Acari).
pastoral: A poem describing the life and manners of shepherds; a poem in which the speakers assume the character of shepherds; an idyll; a bucolic.
venial: Pardonable; able to be forgiven.
resonant: A sonorant vowel or consonant.
circumvent: To avoid or get around something; to bypass
intimation: The act of intimating.
assess: To determine, estimate or judge the value of; to evaluate
utter: Outer; furthest out, most remote.
inclusive: Including (almost) everything within its scope.
molten: To change (or to be changed) from a solid state to a liquid state, usually by a gradual heat.
tinge: A small added amount of colour; (by extension) a small added amount of some other thing.
edify: To build, construct.
filch: Something which has been filched or stolen.
malleable: Able to be hammered into thin sheets; capable of being extended or shaped by beating with a hammer, or by the pressure of rollers.
affable: Receiving others kindly and conversing with them in a free and friendly manner; friendly, courteous, sociable.
afflict: To cause (someone) pain, suffering or distress.
uncouth: Unfamiliar, strange, foreign.
dogged: To pursue with the intent to catch.
vestigial: A small, degenerate, or imperfectly developed part or organ which has been more fully developed in some past generation.
libretto: The text of a dramatic musical work, such as an opera.
clandestine: Done or kept in secret, sometimes to conceal an illicit or improper purpose.
attachment: The act or process of (physically or figuratively) attaching.
inure: To cause someone to become accustomed to something (usually) unpleasant.
disengage: A circular movement of the blade that avoids the opponent's parry
negligent: Careless, without appropriate or sufficient attention.
interdict: A papal decree prohibiting the administration of the sacraments from a political entity under the power of a single person (e.g., a king or an oligarchy with similar powers). Extreme unction/Anointing of the Sick is excepted.
conduct: The act or method of controlling or directing
wraith: A ghost or specter, especially a person's likeness seen just after their death.
efface: To erase (as anything impressed or inscribed upon a surface); to render illegible or indiscernible.
rococo: A style of baroque architecture and decorative art, from 18th-century France, having elaborate ornamentation.
flourish: A dramatic gesture such as the waving of a flag.
petulant: Childishly irritable
affectation: An attempt to assume or exhibit what is not natural or real; false display; artificial show.
aide: An assistant.
arid: Very dry.
flail: A tool used for threshing, consisting of a long handle with a shorter stick attached with a short piece of chain, thong or similar material.
clemency: The gentle or kind exercise of power; leniency, mercy; compassion in judging or punishing.
attempt: The action of trying at something.
intransigent: A person who is intransigent.
normality: The state of being normal or usual; normalcy.
ream: Cream; also, the creamlike froth on ale or other liquor; froth or foam in general.
abase: To lower, as in condition in life, office, rank, etc., so as to cause pain or hurt feelings; to degrade, to depress, to humble, to humiliate.
effusion: A liquid outpouring.
demonstrable: Something that can be demonstrated.
expiate: To atone or make reparation for.
ordain: To prearrange unalterably.
fructify: To bear fruit; to generate useful products or ideas.
gratis: Free, without charge.
jejune: (now rare) Not nutritious.
recourse: The act of seeking assistance or advice.
obtain: To get hold of; to gain possession of, to procure; to acquire, in any way.
cliche: Something, most often a phrase or expression, that is overused or used outside its original context, so that its original impact and meaning are lost. A trite saying; a platitude.
attention: Mental focus.
affinity: A natural attraction or feeling of kinship to a person or thing.
inveterate: To fix and settle after a long time; to entrench.
notice: The act of observing; perception.
remiss: At fault; failing to fulfill responsibility, duty, or obligations.
obviate: To anticipate and prevent or bypass (something which would otherwise have been necessary or required).
pious: Of or pertaining to piety, exhibiting piety, devout, godfearing.
pertinacious: Holding tenaciously to an opinion or purpose.
prate: Talk to little purpose; trifling talk; unmeaningful loquacity.
constrained: To force physically, by strong persuasion or pressuring; to compel; to oblige.
upshot: A concise summary.
cavalier: A military man serving on horse, early modern cavalry officers who had abandoned the heavy armor of medieval knights.
egalitarian: A person who accepts or promotes social equality and equal rights for all people.
nihilist: A person who accepts or champions nihilism.
clique: A small, exclusive group of individuals, usually according to lifestyle or social status; a cabal.
scarce: Uncommon, rare; difficult to find; insufficient to meet a demand.
attractive: Causing attraction; having the quality of attracting by inherent force.
irreverence: The state or quality of being irreverent; want of proper reverence; disregard of the authority and character of a superior.
affluent: Somebody who is wealthy.
oblige: To constrain someone by force or by social, moral or legal means.
shoal: A sandbank or sandbar creating a shallow.
hurtle: A fast movement in literal or figurative sense.
defray: To spend (money).
emend: To correct and revise (text or a document).
suspended: To halt something temporarily.
corpulent: Large in body; fat; overweight.
bate: To reduce the force of something; to abate.
egocentric: A person who is egocentric.
banter: Sharp, good-humoured, playful, typically spontaneous conversation.
ellipsis: A mark consisting of (in English) three periods, historically or more formally with spaces in between, before, and after them “ . . . ”, or more recently a single character “…” Ellipses are used to indicate that words have been omitted in a text or that they are missing or illegible.
auction: A public event where goods or property are sold to the highest bidder.
coalesce: (of separate elements) To join into a single mass or whole.
observe: To notice or view, especially carefully or with attention to detail.
decrepit: Weakened or worn out from age or wear.
knell: The sound of a bell knelling; a toll (particularly one signalling a death).
policy: A principle of behaviour, conduct etc. thought to be desirable or necessary, especially as formally expressed by a government or other authoritative body.
agenda: A temporally organized plan for matters to be attended to.
unanimity: The condition of agreement by all parties, the state of being unanimous.
bore: A hole drilled or milled through something, or (by extension) its diameter.
laggard: One who lags behind; one who takes more time than is necessary or than the others in a group.
conspicuous: Obvious or easy to notice.
benighted: (chiefly in passive) To overtake (a traveller etc) with the darkness of night, especially before shelter is reached.
egregious: Usually in a negative sense: conspicuous, exceptional, outstanding.
aversion: Opposition or repugnance of mind; fixed dislike.
author: The originator or creator of a work, especially of a literary composition.
obviously: In an obvious or clearly apparent manner.
coerce: To restrain by force, especially by law or authority; to repress; to curb.
bluster: Pompous, officious talk.
tyro: A beginner; a novice.
codicil: An addition or supplement that explains, modifies, or revokes a will or part of one.
laconic: Using as few words as possible; pithy and concise.
agrarian: A person who advocates the political interests of working farmers
straight: Something that is not crooked or bent such as a part of a road or track.
mettle: A quality of endurance and courage.
wince: A sudden movement or gesture of shrinking away.
elicit: To evoke, educe (emotions, feelings, responses, etc.); to generate, obtain, or provoke as a response or answer.
waffle: A flat pastry pressed with a grid pattern.
retort: A sharp or witty reply, or one which turns an argument against its originator; a comeback.
sententious: Full of meaning.
conceit: Something conceived in the mind; an idea, a thought.
occur: To happen or take place.
autograph: A person’s own handwriting, especially the signature of a famous or admired person.
cognitive: Cognate.
tantrum: An often childish display or fit of bad temper.
debase: To lower in character, quality, or value; to degrade.
legerdemain: Sleight of hand; "magic" trickery.
roil: To render turbid by stirring up the dregs or sediment of.
aggregate: A mass, assemblage, or sum of particulars; something consisting of elements but considered as a whole.
stock: A store or supply.
interpolate: To introduce (something) between other things; especially to insert (possibly spurious) words into a text.
nugatory: Trivial, trifling or of little importance.
elliptical: An elliptical galaxy.
cabal: # A putative, secret organization of individuals gathered for a political purpose.
loquacious: Talkative; chatty.
bolt: A (usually) metal fastener consisting of a cylindrical body that is threaded, with a larger head on one end. It can be inserted into an unthreaded hole up to the head, with a nut then threaded on the other end; a heavy machine screw.
loath: Averse, disinclined; reluctant, unwilling.
awesome: Short for awesomeness: the quality, state, or essence of being awesome.
indigent: A person in need, or in poverty.
cognizant: Aware; fully informed; having understanding of a fact
omit: To leave out or exclude.
retainer: Any thing or person that retains.
libertarian: One who advocates liberty, either generally or in relation to a specific issue.
inconsequential: Something unimportant; something that does not matter.
agnostic: A person who holds to a form of agnosticism, especially uncertainty of the existence of a deity.
apparent: Capable of being seen, or easily seen; open to view; visible to the eye, eyely; within sight or view.
surreptitious: Stealthy, furtive, well hidden, covert (especially movements).
surly: Irritated, bad-tempered, unfriendly.
elusive: Evading capture, comprehension or remembrance.
rampart: A defensive mound of earth or a wall with a broad top and usually a stone parapet; a wall-like ridge of earth, stones or debris; an embankment for defensive purpose.
assent: Agreement; act of agreeing
peon: A lowly person; a peasant or serf; a labourer who is obliged to do menial work.
considerate: To think about seriously.
coherent: Unified; sticking together; making up a whole.
imperious: Domineering, arrogant, or overbearing.
subjugate: To forcibly impose obedience or servitude upon.
opportunity: A chance for advancement, progress or profit.
licentious: Lacking restraint, or ignoring societal standards, particularly in sexual conduct.
effervescence: The escape of gas from solution in a liquid, especially the escape of carbon dioxide from a carbonated drink.
alacrity: Eagerness; liveliness; enthusiasm.
property: Something that is owned.
dissimulate: To practise deception by concealment or omission, or by feigning a false appearance.
scathing: To injure or harm.
emigrate: To leave the country in which one lives, especially one's native country, in order to reside elsewhere.
vitiate: To spoil, make faulty; to reduce the value, quality, or effectiveness of something
extort: To take or seize off an unwilling person by physical force, menace, duress, torture, or any undue or illegal exercise of power or ingenuity
purse: A small bag for carrying money.
convince: To make someone believe, or feel sure about something, especially by using logic, argument or evidence.
colloquial: A colloquial word or phrase, colloquialism
suffuse: To spread through or over something, especially as a liquid, colour or light; to bathe.
fraught: The hire of a ship or boat to transport cargo.
opposition: The action of opposing or of being in conflict.
linchpin: A pin inserted through holes at the end of an axle or shaft, so as to secure a wheel or shaft-mounted device.
stultify: To prove to be of unsound mind or demonstrate someone's incompetence.
allege: To state under oath, to plead.
fancy: The imagination.
ruse: A turning or doubling back, especially of animals to get out of the way of hunting dogs.
hearken: (obsolete except poetic) To hear (something) with attention; to have regard to (something).
eminent: High, lofty.
unassuming: Modest and having no pretensions or ostentation
lode: A way or path; a road.
tarry: A sojourn.
plus: A positive quantity.
coordinator: One who coordinates.
collusion: A secret agreement for an illegal purpose; conspiracy.
rash: Acting too quickly without considering the risks and consequences; not careful; hasty.
optimist: A person who expects a favourable outcome
tureen: A broad, deep serving dish used for serving soup or stew.
alleviate: To make less severe, as a pain or difficulty.
august: Awe-inspiring, majestic, noble, venerable.
litigant: A party suing or being sued in a lawsuit, or otherwise calling upon the judicial process to determine the outcome of a suit.
concept: An abstract and general idea; an abstraction.
specious: Seemingly well-reasoned, plausible or true, but actually fallacious.
empirical: Pertaining to or based on experience.
faze: To frighten or cause hesitation; to daunt, put off (usually used in the negative); to disconcert, to perturb.
libertine: Someone freed from slavery in Ancient Rome; a freedman.
fanfare: A flourish of trumpets or horns as to announce; a short and lively air performed on hunting horns during the chase.
perpetrate: To be guilty of, or responsible for a crime etc; to commit.
sanction: An approval, by an authority, generally one that makes something valid.
creature: A living being; an animal or (sometimes derogatory) a human.
argot: A secret language or conventional slang peculiar to thieves, tramps and vagabonds.
option: One of a set of choices that can be made.
commensurate: To reduce to a common measure.
maelstrom: A large and violent whirlpool.
pellucid: Allowing the passage of light; transparent.
fissure: A crack or opening, as in a rock.
court: An enclosed space; a courtyard; an uncovered area shut in by the walls of a building, or by different buildings; also, a space opening from a street and nearly surrounded by houses; a blind alley.
allocate: To set aside for a purpose.
revulsion: Abhorrence, a sense of loathing, intense aversion, repugnance, repulsion, horror.
emulate: To attempt to equal or be the same as.
lithe: To go.
maul: A heavy long-handled hammer, used for splitting logs by driving a wedge into them, or in combat.
decorum: Appropriate social behavior.
pusillanimous: Showing ignoble cowardice, or contemptible timidity.
proceeding: To move, pass, or go forward or onward; to advance; to carry on
crevice: A narrow crack or fissure, as in a rock or wall.
forfeit: A penalty for or consequence of a misdemeanor.
parallel: One of a set of parallel lines.
euphony: A pronunciation of letters and syllables which is pleasing to the ear.
invidious: Causing ill will, envy, or offense.
maudlin: The Magdalene; Mary Magdalene.
appoint: To set, fix or determine (a time or place for something such as a meeting, or the meeting itself) by authority or agreement.
knoll: A small mound or rounded hill.
hale: Health, welfare.
luxuriant: Abundant in growth or detail.
ingrained: To dye with a fast or lasting colour.
endemic: An individual or species that is endemic to a region.
compelling: To drive together, round up
alloy: A metal that is a combination of two or more elements, at least one of which is a metal.
exalt: To honor; to hold in high esteem.
criminal: A person who is guilty of a crime, notably breaking the law.
convalesce: To recover health and strength gradually after sickness or weakness.
pedestal: The base or foot of a column, statue, vase, lamp.
veracious: True.
redoubtable: Eliciting respect or fear; imposing; awe-inspiring.
callous: Emotionally hardened; unfeeling and indifferent to the suffering/feelings of others.
maverick: An unbranded range animal.
obtuse: To dull or reduce an emotion or a physical state.
passage: A paragraph or section of text or music with particular meaning.
tawdry: Tawdry lace.
enervate: To reduce strength or energy; debilitate.
compendium: A short, complete summary; an abstract.
siege: (heading) Military action.
allusion: An indirect reference; a hint; a reference to something supposed to be known, but not explicitly mentioned
quagmire: A swampy, soggy area of ground.
cant: An argot, the jargon of a particular class or subgroup.
stipulate: To require (something) as a condition of a contract or agreement.
personality: A set of non-physical psychological and social qualities that make a person (or thing) distinct from another.
crystal: A solid composed of an array of atoms or molecules possessing long-range order and arranged in a pattern which is periodic in three dimensions.
pendulous: Hanging as if from a support
abet: Fraud or cunning.
inculcate: To teach by repeated instruction.
mawkish: Feeling sick, queasy.
querulous: Often complaining; suggesting a complaint in expression; fretful, whining.
vain: Overly proud of oneself, especially concerning appearance; having a high opinion of one's own accomplishments with slight reason.
trite: Often in reference to a word or phrase: used so many times that it is commonplace, or no longer interesting or effective; worn out, hackneyed.
enfranchise: To grant the franchise to an entity, specifically:
complacent: Uncritically satisfied with oneself or one's achievements; smug.
malice: Intention to harm or deprive in an illegal or immoral way. Desire to take pleasure in another's misfortune.
edict: A proclamation of law or other authoritative command.
aloof: Reserved and remote; either physically or emotionally distant; standoffish.
flaccid: Flabby.
plait: A flat fold; a doubling, as of cloth; a pleat.
curious: Tending to ask questions, or to want to explore or investigate; inquisitive; (with a negative connotation) nosy, prying.
exegesis: An exposition or explanation of a text, especially a religious one.
nettle: Any plant whose foliage is covered with stinging, mildly poisonous hairs, causing an instant rash.
mendacious: (of a person) Lying, untruthful or dishonest.
proclivity: A predisposition or natural inclination, propensity, or a predilection; especially, a strong disposition or bent.
vagary: An erratic, unpredictable occurrence or action.
instance: Urgency of manner or words; an urgent request; insistence.
hireling: (usually derogatory) An employee who is hired, often to perform unpleasant tasks with little independence.
engender: To beget (of a man); to bear or conceive (of a woman).
complaisant: Compliant.
mannered: (often in combination) Having manners or (often excessive) mannerisms.
extravagant: Exceeding the bounds of something; roving; hence, foreign.
disconcert: A state of disunion.
altruism: Regard for others, both natural and moral without regard for oneself; devotion to the interests of others; brotherly kindness.
somatic: Part of, or relating to the body of an organism.
precious: Someone (or something) who is loved; a darling.
damage: Injury or harm; the condition or measure of something not being intact.
effluvium: A gaseous or vaporous emission, especially a foul-smelling one.
blanch: To grow or become white
morass: A tract of soft, wet ground; a marsh; a fen.
incipient: Beginner
quarry: A site for mining stone, limestone, or slate.
ensconce: To place in a secure environment.
coast: The edge of the land where it meets an ocean, sea, gulf, bay, or large lake.
enigma: Something or someone puzzling, mysterious or inexplicable.
complicity: The state of being complicit; involvement as a partner or accomplice, especially in a crime or other wrongdoing.
squeamish: Easily bothered or upset; tendisymmetry: Exact correspondence on either side of a dividing line, plane, center or axis.
enormity: Deviation from what is normal or standard; irregularity, abnormality.
throng: A group of people crowded or gathered closely together.
address: Direction.
apposite: That which is apposite; something suitable.
comprehensive: A comprehensive school.
vaunt: A boast; an instance of vaunting.
decision: The act of deciding.
predator: Any animal or other organism that hunts and kills other organisms (their prey), primarily for food.
jubilant: In a state of elation.
inscrutable: One who or that which is inscrutable; a person, etc. that cannot be comprehended.
project: A planned endeavor, usually with a specific goal and accomplished in several steps or stages.
arbitrate: To make a judgment (on a dispute) as an arbitrator or arbiter
ephemeral: Something which lasts for a short period of time.
obdurate: To harden; to obdure.
venerate: To treat with great respect and deference.
ambience: A particular mood or atmosphere of an environment or surrounding influence.
viscous: Having a thick, sticky consistency between solid and liquid.
comprise: To be made up of; to consist of (especially a comprehensive list of parts).
pernicious: Causing much harm in a subtle way.
decorate: To furnish with decorations.
presence: The fact or condition of being present, or of being within sight or call, or at hand.
mores: A set of moral norms or customs derived from generally accepted practices rather than written laws.
bustle: An excited activity; a stir.
tenacious: Clinging to an object or surface; adhesive.
cleave: Flat, smooth surface produced by cleavage, or any similar surface produced by similar techniques, as in glass.
commission: A sending or mission (to do or accomplish something).
epigram: An inscription in stone.
refractory: A material or piece of material, such as a brick, that has a very high melting point.
ambiguous: Open to multiple interpretations.
assail: To attack with harsh words or violent force (also figuratively).
misanthrope: One who hates all mankind; one who hates the human race.
conciliatory: Willing to conciliate, or to make concessions.
miserly: Like a miser; very covetous; cautious with money
gash: A deep cut.
delicious: Pleasing to taste; tasty.
prey: Anything, as goods, etc., taken or got by violence; anything taken by force from an enemy in war
skimp: To mock, deride, scorn, scold, make fun of.
multifarious: Having great diversity or variety; of various kinds; made up of many differing parts; manifold.
incisive: Quickly proceeding to judgment and forceful in expression; decisive; forthright.
thrall: One who is enslaved or under mind control.
epigraph: An inscription, especially on a building.
dregs: (collectively) The sediment settled at the bottom of a liquid; the lees in a container of unfiltered wine.
append: An instance of writing more data to the end of an existing file.
constant: That which is permanent or invariable.
sublime: To sublimate.
vintner: A seller of wine.
ambivalent: Simultaneously experiencing or expressing opposing or contradictory feelings, beliefs, or motivations.
concise: To make concise; to abridge or summarize.
vapid: Offering nothing that is stimulating or challenging.
entreat: An entreaty.
demolish: To destroy.
principal: The money originally invested or loaned, on which basis interest and returns are calculated.
garble: Confused or unintelligible speech.
nadir: The point of the celestial sphere, directly opposite the zenith; inferior pole of the horizon; point of the celestial sphere directly under the place of observation.
errant: A knight-errant.
visage: Countenance; appearance; one's face.
disconsolate: Disconsolateness.
ascendancy: The process or period of one's ascent
epitaph: An inscription on a gravestone in memory of the deceased.
circumstances: That which attends, or relates to, or in some way affects, a fact or event; an attendant thing or state of things.
exploit: A heroic or extraordinary deed.
halcyon: A kingfisher said in classical mythology to nest on the sea, thereby calming the waters.
ameliorate: To make better, or improve, something perceived to be in a negative condition.
concord: A state of agreement; harmony; union.
mercurial: Any of the plants known as mercury, especially the annual mercury or French mercury (Mercurialis annua).
demonstrate: To show how to use (something).
veneer: A thin decorative covering of fine material (usually wood) applied to coarser wood or other material.
principle: A fundamental assumption or guiding belief.
incendiary: Something capable of causing fire, particularly a weapon.
sedulous: Of a person: diligent in application or pursuit; constant and persevering in business or in endeavours to effect a goal; steadily industrious.
horde: A wandering troop or gang; especially, a clan or tribe of a nomadic people (originally Tatars) migrating from place to place for the sake of pasturage, plunder, etc.; a predatory multitude.
neophyte: A beginner; a person who is new to a subject, skill, or belief.
impetus: Something that impels; a stimulating factor.
pundit: An expert in a particular field, especially as called upon to provide comment or opinion in the media; a commentator, a critic.
epithet: A term used to characterize a person or thing.
constitute: An established law.
exertion: An expenditure of physical or mental effort.
anthropomorphic: Having the form of a human
amiable: Friendly; kind; sweet; gracious
concurrent: One who, or that which, concurs; a joint or contributory cause.
perspicuous: Clearly expressed, easy to understand; lucid.
wheedle: A coaxing person.
depot: A storage facility, in particular, a warehouse.
incandescent: An incandescent lamp or bulb
stature: A person or animal's natural height when standing upright.
professor: The most senior rank for an academic at a university or similar institution, informally also known as "full professor." Abbreviated Prof.
parable: A short narrative illustrating a lesson (usually religious/moral) by comparison or analogy.
noisome: Morally hurtful or noxious.
imposition: The act of imposing, laying on, affixing, enjoining, inflicting, obtruding, and the like.
commiserate: Commiserating, pitying, lamentful
epitome: The embodiment or encapsulation of a class of items.
level: A tool for finding whether a surface is level, or for creating a horizontal or vertical line of reference.
kindle: To start (a fire) or light (a torch, a match, coals, etc.).
turgid: Distended beyond the natural state by some internal agent, especially fluid, or expansive force.
nonplus: A state of perplexity or bewilderment.
amnesty: Forgetfulness; cessation of remembrance of wrong; oblivion.
condescend: To come down from one's superior position; to deign (to do something).
espouse: To become/get married to.
derelict: Property abandoned by its former owner, especially a ship abandoned at sea.
depression: In psychotherapy and psychiatry, a state of mind producing serious, long-term lowering of enjoyment of life or inability to visualize a happy future.
dwindle: To decrease, shrink, diminish, reduce in size or intensity.
punctual: Prompt; on time.
foil: A very thin sheet of metal.
noxious: Harmful; injurious.
auspices: (chiefly in the plural) Patronage or protection.
alcove: A small recessed area set off from a larger room.
equanimity: The state of being calm, stable and composed, especially under stress.
endow: To provide with a dower or a dowry.
institute: An organization founded to promote a cause
malaise: A feeling of general bodily discomfort, fatigue or unpleasantness, often at the onset of illness.
enamor: (mostly in the passive, followed by "of" or "with") To cause to be in love.
condone: To forgive, excuse or overlook (something that is considered morally wrong, offensive, or generally disliked).
vouchsafe: To graciously give, to condescendingly grant a right, benefit, outcome, etc.; to deign to acknowledge.
entomology: The scientific study of insects, and (informally) of other arthropods (and occasionally other invertebrates).
deprived: To take something away from (someone) and keep it away; to deny someone something.
pursuit: The act of pursuing.
molt: The process of shedding or losing a covering of fur, feathers or skin etc.
obfuscate: To make dark; overshadow
veritable: True; genuine.
sonorous: Capable of giving out a deep, resonant sound.
assay: Trial, attempt.
equitable: Marked by or having equity.
imposed: To establish or apply by authority.
render: Stucco or plaster applied to walls (mostly to outside masonry walls).
polemical: A diatribe or polemic.
amorous: Inclined or having a propensity to love, or to sexual enjoyment.
pedagogue: A teacher or instructor of children; one whose occupation is to teach the young.
execrable: Of the poorest quality.
conducive: Tending to contribute to, encourage, or bring about some result.
bluff: An act of bluffing; a false expression of the strength of one's position in order to intimidate; braggadocio.
edible: Anything edible.
muscle: A contractile form of tissue which animals use to effect movement.
fallow: Ground ploughed and harrowed but left unseeded for one year.
obstreperous: Attended by, or making, a loud and tumultuous noise; boisterous.
exploitation: The act of utilizing something; industry.
grapple: A close hand-to-hand struggle; the act of grappling.
parochial: Pertaining to a parish.
equivocal: A word or expression capable of different meanings; an ambiguous term.
humiliate: To injure the dignity and self-respect of.
appeal: An application for the removal of a cause or suit from an inferior to a superior judge or court for re-examination or review.
amorphous: Lacking a definite form or clear shape.
gadfly: Any dipterous insect of the family Oestridae, commonly known as botflies.
acme: The top or highest point; pinnacle; culmination.
sluice: An artificial passage for water, fitted with a valve or gate, for example in a canal lock or a mill stream, for stopping or regulating the flow.
confluence: The place where two rivers, streams, or other continuously flowing bodies of water meet and become one, especially where a tributary joins a river.
immaculate: Having no stain or blemish; spotless, undefiled, clear, clean, pure.
eerie: Strange, weird, fear-inspiring.
museum: A building or institution dedicated to the acquisition, conservation, study, exhibition, and educational interpretation of objects having scientific, historical, cultural or artistic value.
saunter: A leisurely walk or stroll.
officious: Obliging, attentive, eager to please.
conjugal: Of or relating to marriage, or the relationship of spouses; connubial.
gentry: Birth; condition; rank by birth.
dint: A blow, stroke, especially dealt in a fight.
erudite: A learned or scholarly person
suffrage: The right or chance to vote, express an opinion, or participate in a decision.
anachronism: A chronological mistake; the erroneous dating of an event, circumstance, or object.
generate: To bring into being; give rise to.
atavism: The reappearance of an ancestral characteristic in an organism after several generations of absence.
masticate: To chew (food).
moot: A moot court.
congenial: Having the same or very similar nature, personality, tastes, habits or interests.
respite: A brief interval of rest or relief.
effect: The result or outcome of a cause.
mysterious: Of unknown origin.
onerous: Imposing or constituting a physical, mental, or figurative load which can be borne only with effort; burdensome.
droll: A funny person; a buffoon, a wag.
maxim: A self-evident axiom or premise; a pithy expression of a general principle or rule.
esoteric: An esoteric doctrine or treatise; esoteric philosophy.
abjure: To renounce upon oath; to forswear; to disavow.
ignominious: Marked by shame or disgrace.
ensue: To follow (a leader, inclination etc.).
analogy: A relationship of resemblance or equivalence between two situations, people, or objects, especially when used as a basis for explanation or extrapolation.
sinecure: A position that requires no work but still gives an ample payment; a cushy job.
theory: A description of an event or system that is considered to be accurate.
contusion: A wound, such as a bruise, in which the skin is not broken, often having broken blood vessels and discolouration.
dapper: Neat, trim.
congenital: (of a trait or a disease) Present since birth.
personable: (of a person) Having a pleasing appearance or manner; attractive; handsome; friendly; amiable.
effective: A soldier fit for duty
mystery: Something secret or unexplainable; an unknown.
ostracism: In ancient Athens (and some other cities), the temporary banishment by popular vote of a citizen considered dangerous to the state.
sequester: Sequestration; separation
projection: Something which projects, protrudes, juts out, sticks out, or stands out.
ethereal: Pertaining to the hypothetical upper, purer air, or to the higher regions beyond the earth or beyond the atmosphere; celestial; otherworldly.
amicable: Showing friendliness or goodwill.
frieze: A kind of coarse woolen cloth or stuff with a shaggy or tufted (friezed) nap on one side.
gale: To sing; charm; enchant.
anecdote: A short account of a real incident or person, often humorous or interesting.
indite: To physically make letters and words on a writing surface; to inscribe.
range: A line or series of mountains, buildings, etc.
parsimonious: Exhibiting parsimony; sparing in the expenditure of money; frugal to excess.
asperity: Roughness as of stone or weather.
conjecture: A statement or an idea which is unproven, but is thought to be true; a guess.
emerge: To come into view.
impunity: Exemption from punishment.
mystic: Someone who practices mysticism.
badinage: Playful raillery; banter.
panacea: A remedy believed to cure all disease and prolong life that was originally sought by alchemists; a cure-all.
prowess: Skillfulness and manual ability; adroitness or dexterity.
euphemism: The use of a word or phrase to replace another with one that is considered less offensive, blunt or vulgar than the word or phrase which it replaces.
ornate: To adorn; to honour.
onset: An attack; an assault especially of an army.
campaign: A series of operations undertaken to achieve a set goal.
muse: A source of inspiration.
emetic: An agent that induces vomiting
anguish: Extreme pain, either of body or mind; excruciating distress.
dulcet: Sweet, especially when describing voice or tones; melodious.
flair: A natural or innate talent or aptitude.
conjure: The practice of magic; hoodoo; conjuration.
insouciant: Casually unconcerned; carefree, indifferent, nonchalant.
endangered: To put (someone or something) in danger; to risk causing harm to.
myth: A traditional story which embodies a belief regarding some fact or phenomenon of experience, and in which often the forces of nature and of the soul are personified; a sacred narrative regarding a god, a hero, the origin of the world or of a people, etc.
versed: To compose verses.
paradigm: A pattern, a way of doing something, especially a pattern of thought, a system of beliefs, a conceptual framework.
dingy: Drab; shabby; dirty; squalid
evanescent: Disappearing, vanishing.
inflammatory: Any material that causes inflammation
conservatory: That which preserves from injury.
labor: Effort expended on a particular task; toil, work.
satire: A literary device of writing or art which principally ridicules its subject often as an intended means of provoking or preventing change. Humor, irony, and exaggeration are often used to aid this.
unimpeachable: Not able to be impeached or reproached.
animosity: Violent hatred leading to active opposition; active enmity; energetic dislike.
reprise: A recurrence or resumption of an action.
mote: A small particle; a speck.
connoisseur: A specialist in a given field whose opinion is highly valued, especially in one of the fine arts or in matters of taste
energy: The impetus behind all motion and all activity.
mordant: Any substance used to facilitate the fixing of a dye to a fibre; usually a metallic compound which reacts with the dye using chelation.
queue: An animal's tail.
pariah: A person who is rejected from society or home; an outcast.
impugn: To assault, attack.
semblance: Likeness, similarity; the quality of being similar.
exacerbate: To make worse (a problem, bad situation, negative feeling, etc.); aggravate; exasperate.
machination: A clever scheme or artful plot, usually crafted for evil purposes.
voluble: (of a person or a manner of speaking) Fluent or having a ready flow of speech; garrulous or loquacious; tonguey.
confer: To grant as a possession; to bestow.
intrigue: A complicated or clandestine plot or scheme intended to effect some purpose by secret artifice; conspiracy; stratagem.
genesis: The origin, start, or point at which something comes into being.
anomaly: A deviation from a rule or from what is regarded as normal; an outlier.
anodyne: Any medicine or other agent that relieves pain
inimical: Harmful in effect.
consecrate: To declare something holy, or make it holy by some procedure.
engage: (heading) To interact socially.
quaint: Of a person: cunning, crafty.
renounce: An act of renouncing.
paucity: Fewness in number; too few.
amenity: Pleasantness.
tout: Someone advertising for customers in an aggressive way.
exacting: To demand and enforce the payment or performance of, sometimes in a forcible or imperious way.
yeoman: An official providing honorable service in a royal or high noble household, ranking between a squire and a page. Especially, a Yeoman of the Guard, a member of a ceremonial bodyguard to the UK monarch (not to be confused with a Yeoman Warder).
mendicant: A pauper who lives by begging.
indication: Act of pointing out or indicating.
grant: The act of granting; a bestowing or conferring; concession; allowance; permission.
suavity: The quality of being sweet or pleasing to the mind; agreeableness; pleasantness
antecedent: Any thing that precedes another thing, especially the cause of the second thing.
abnegation: A denial; a renunciation; denial of desire or self-interest.
consonant: A sound that results from the passage of air through restrictions of the oral cavity; any sound that is not the dominant sound of a syllable, the dominant sound generally being a vowel.
apropos: Of an appropriate or pertinent nature.
feature: One's structure or make-up: form, shape, bodily proportions.
quay: A stone or concrete structure on navigable water used for loading and unloading vessels; a wharf.
pejorative: A disparaging, belittling, or derogatory word or expression.
careen: The position of a ship laid on one side.
fortitude: Mental or emotional strength that enables courage in the face of adversity.
taunt: A scornful or mocking remark; a jeer or mockery
exasperate: To tax the patience of, irk, frustrate, vex, provoke, annoy; to make angry.
levity: Lightness of manner or speech, frivolity; lack of appropriate seriousness; inclination to make a joke of serious matters.
bullion: A bulk quantity of precious metal, usually gold or silver, assessed by weight and typically cast as ingots.
cower: To crouch or cringe, or to avoid or shy away from something, in fear.
dwell: A period of time in which a system or component remains in a given state.
stentorian: (of a voice) Loud, powerful, booming, suitable for giving speeches to large crowds.
antipathy: A feeling of dislike (normally towards someone, less often towards something); repugnance or distaste.
abrogate: To annul by an authoritative act; to abolish by the authority of the maker or her or his successor; to repeal; — applied to the repeal of laws, decrees, ordinances, the abolition of customs, etc.
gruel: A thin, watery porridge, formerly eaten primarily by the poor and the ill.
construe: A translation.
fellowship: A company of people that share the same interest or aim.
penurious: Miserly; excessively cheap.
revelry: Joyful or riotous merry-making.
quench: The abnormal termination of operation of a superconducting magnet, occurring when part of the superconducting coil enters the normal (resistive) state.
asunder: Into separate parts or pieces.
exult: To rejoice; to be very happy, especially in triumph.
exemplify: To show or illustrate by example.
diffidence: The state of being diffident, timid or shy; reticence or self-effacement.
rapt: An ecstasy; a trance.
wont: One's habitual way of doing things; custom, habit, practice.
entertain: Entertainment; pleasure.
antithesis: A proposition that is the diametric opposite of some other proposition.
junket: A basket.
abscond: To flee, often secretly; to steal away, particularly to avoid arrest or prosecution.
gentility: The state of being elegant, genteel, having good breeding, or being socially superior.
consummate: To bring (a task, project, goal etc.) to completion; to accomplish.
effete: Of substances, quantities etc: exhausted, spent, worn-out.
fete: A festival open to the public, the proceeds from which are often given to charity.
philanthropic: Of or pertaining to philanthropy; characterized by philanthropy; loving or helping mankind
query: A question, an inquiry (US), an enquiry (UK).
rout: A noise, especially a loud one
imbroglio: A complicated situation; an entanglement.
exhaustive: Including every possible element
makeshift: A temporary (usually insubstantial) substitution.
sultry: Hot and humid.
appurtenance: An appendage to something else; an addition.
apathy: Lack of emotion or motivation; lack of interest or enthusiasm towards something; disinterest (in something).
contract: An agreement between two or more parties, to perform a specific job or work order, often temporary or of fixed duration and usually governed by a written agreement.
tract: An area or expanse.
disapprobation: An act or expression of condemnation or disapproval, especially on moral grounds.
accretion: The act of increasing by natural growth; especially the increase of organic bodies by the internal accession of parts; organic growth.
contiguous: Connected; touching; abutting.
knack: A readiness in performance; aptness at doing something.
fiction: Literary type using invented or imaginative writing, instead of real facts, usually written as prose.
plaudit: (often in the plural) A mark or expression of applause; praise bestowed.
staid: Not capricious or impulsive; sedate, serious, sober.
ravine: A deep narrow valley or gorge in the earth's surface worn by running water.
exhort: To urge; to advise earnestly.
nostrum: A medicine or remedy in conventional use which has not been proven to have any desirable medical effects.
surfeit: An excessive amount of something.
podium: A platform on which to stand, as when conducting an orchestra or preaching at a pulpit.
aphorism: An original, laconic phrase conveying some principle or concept of thought.
pinion: A wing.
earnest: Gravity; serious purpose; earnestness.
canon: A generally accepted principle; a rule.
gouge: Senses relating to cutting tools.
adumbrate: To foreshadow vaguely.
contrite: A contrite person; a penitent.
rift: A chasm or fissure.
fierce: Exceedingly violent, severe, ferocious, cruel or savage.
beguile: To deceive or delude (using guile).
plethora: (usually followed by of) An excessive amount or number; an abundance.
realistic: Expressed or represented as being accurate, practicable, or not idealistic.
exigency: (chiefly in the plural) The demands or requirements of a situation.
immure: A wall; an enclosure.
bungle: A botched or incompetently handled situation.
granary: A storage facility for grain or sometimes animal feed.
apocryphal: Of, or pertaining to, the Apocrypha.
descry: To see.
wander: The act or instance of wandering.
impel: To urge a person; to press on; to incite to action or motion via intrinsic motivation.
oratorio: A musical composition, often based on a religious theme; similar to opera but with no costume, scenery or acting.
aggrandize: To make great; to enlarge; to increase.
contrived: To invent by an exercise of ingenuity; to devise
vault: An arched masonry structure supporting and forming a ceiling, whether freestanding or forming part of a larger building.
formal: Formalin.
purport: Import, intention or purpose
portent: Something that portends an event about to occur, especially an unfortunate or evil event; an omen.
receive: An operation in which data is received.
existential: Ellipsis of existential clause
inveigle: To convert, convince, or win over with flattery or wiles.
astringent: A substance which draws tissue together, thus restricting the flow of blood.
imposture: The act or conduct of an impostor; deception practiced under a false or assumed character; fraud or imposition
functionary: A person employed as an official in a bureaucracy (usually corporate or governmental) who holds limited authority and primarily serves to carry out a simple function for which discretion is not required.
apotheosis: The fact or action of becoming or making into a god; deification.
insist: (with on or upon or (that + ordinary verb form)) To hold up a claim emphatically.
latitude: The angular distance north or south from a planet's equator, measured along the meridian of that particular point.
inclement: Stormy, of rough weather
alias: Another name; an assumed name.
convivial: Having elements of a feast or of entertainment, especially when it comes to eating and drinking, with accompanying festivity
feisty: Tenacious, energetic, spunky.
fracture: An instance of breaking, a place where something has broken.
deprave: To speak ill of; to depreciate; to malign; to revile
potentate: A powerful leader; a monarch; a ruler.
recent: Having happened a short while ago.
exonerate: To relieve (someone or something) of a load; to unburden (a load).
unfaltering: Without faltering, continuous, steadfast.
postulate: Something assumed without proof as being self-evident or generally accepted, especially when used as a basis for an argument. Sometimes distinguished from axioms as being relevant to a particular science or context, rather than universally true, and following from other axioms rather than being an absolute assumption.
diadem: An ornamental headband worn as a badge of royalty.
imbibe: To drink (used frequently of alcoholic beverages).
appease: To make quiet; to calm; to reduce to a state of peace; to dispel (anger or hatred).
knight: A young servant or follower; a trained military attendant in service of a lord.
vacate: To move out of a dwelling, either by choice or by eviction.
scintilla: A small spark or flash.
anachronistic: Erroneous in date; containing an anachronism; in a wrong time; not applicable to or not appropriate for the time.
copious: Vast in quantity or number, profuse, abundant; taking place on a large scale.
rile: To make angry
fragile: Easily broken or destroyed, and thus often of subtle or intricate structure.
bequeath: To give or leave by will; to give by testament.
preclude: Remove the possibility of; rule out; prevent or exclude; to make impossible.
recommend: To bestow commendation on; to represent favourably; to suggest, endorse or encourage as an appropriate choice.
tutelage: The act of guarding, protecting, or guiding; guardianship; protection
indulgent: Disposed or prone to indulge, humor, gratify, or yield to one's own or another's desires, etc., or to be compliant, lenient, or forbearing;
expatriate: One who lives outside their own country.
hubbub: A confused uproar, commotion, tumult or racket.
apprehensive: Anticipating something with anxiety or fear.
diversified: Modified by diversification
inspire: To infuse into the mind; to communicate to the spirit; to convey, as by a divine or supernatural influence; to disclose preternaturally; to produce in, as by inspiration.
undertaking: To take upon oneself; to start, to embark on (a specific task etc.).
squalor: Filthiness and degradation, as from neglect or poverty
anathema: A ban or curse pronounced with religious solemnity by ecclesiastical authority, often accompanied by excommunication; something denounced as accursed.
corollary: Something given beyond what is actually due; something added or superfluous.
pall: Senses relating to cloth.
frenzied: In a state of hurry, panic or wild activity.
vassal: The grantee of a fief, feud, or fee; one who keeps land of a superior, and who vows fidelity and homage to him, normally a lord of a manor; a feudatory; a feudal tenant.
predilection: Condition of favoring or liking; tendency towards; proclivity; predisposition.
testator: One who dies having made a legally valid will.
temerity: Reckless boldness; foolish bravery.
relationship: Connection or association; the corroborate: To confirm or support something with additional evidence; to attest or vouch for.
expedient: A method or means for achieving a particular result, especially when direct or efficient; a resource.
maraud: To move about in roving fashion looking for plunder.
convention: A meeting or gathering.
slay: To kill, murder.
annex: An addition, an extension.
galaxy: The Milky Way; the apparent band of concentrated stars which appears in the night sky over earth.
relevant: Directly related, connected, or pertinent to a topic.
fracas: A noisy disorderly quarrel, fight, brawl, disturbance or scrap.
regimen: Orderly government; system of order; administration.
symmetry: Exact correspondence on either side of a dividing line, plane, center or axis.
cosmopolitan: A cosmopolitan person; a cosmopolite.
expedite: To accelerate the progress of.
grudging: To be unwilling to give or allow (someone something).
dispassionate: Not showing, and not affected by, emotion, bias, or prejudice
skill: Capacity to do something well; technique, ability. Skills are usually acquired or learned, as opposed to abilities, which are often thought of as innate.
predecessor: One who precedes; one who has preceded another in any state, position, office, etc.; one whom another follows or comes after, in any office or position.
reluctant: Opposing; offering resistance (to).
antediluvian: One who lived prior to Noah's Flood.
approbation: The act of approving; an assenting to the propriety of a thing with some degree of pleasure or satisfaction; approval, sanction, commendation or official recognition.
generation: The fact of creating something, or bringing something into being; production, creation.
preponderance: Excess or superiority of weight, influence, or power, etc.; an outweighing.
gloat: An act or instance of gloating.
charade: A genre of riddles where the clues to the answer are descriptions or puns on its syllables, with a final clue to the whole.
quail: To waste away; to fade, to wither
stricture: (usually in plural) a rule restricting behaviour or action
countenance: Appearance, especially the features and expression of the face.
explicit: Very specific, clear, or detailed.
partiality: Preference, bias in favor of, tendency.
harrowing: To drag a harrow over; to break up with a harrow.
financial: Related to finances.
delicacy: The quality of being delicate.
antiseptic: Any substance that inhibits the growth and reproduction of microorganisms. Generally includes only those that are used on living objects (as opposed to disinfectants) and aren't transported by the lymphatic system to destroy bacteria in the body (as opposed to antibiotics).
remnant: The small portion remaining of a larger thing or group.
aptitude: Natural ability to acquire knowledge or skill.
gesture: A motion of the limbs or body, especially one made to emphasize speech.
elysian: Of or pertaining to Elysian or Elysium, the location.
presage: A warning of a future event; an omen.
yokel: An unsophisticated person.
reconnoiter: An act or instance of reconnoitering.
outskirts: The area surrounding a city or town; suburb.
coup: A quick, brilliant, and highly successful act.
emblazon: To adorn with prominent markings.
philology: The humanistic study of historical linguistics.
implicit: Implied indirectly, without being directly expressed
apathetic: Void of feeling; not susceptible of deep emotion
beseech: A request.
reflect: To bend back (light, etc.) from a surface.
askance: To look at (someone or something) with a sideways glance.
probity: Integrity, especially of the quality of having strong moral principles; honesty and decency.
scavenger: Someone who scavenges, especially one who searches through rubbish for food or useful things.
gigantic: Very large.
arcane: Understood by only a few.
wanton: A pampered or coddled person.
fulminate: Any salt or ester of fulminic acid, mostly explosive.
bulwark: A defensive wall or rampart.
martinet: A strict disciplinarian.
augury: A divination based on the appearance and behaviour of animals.
covet: To wish for with eagerness; to desire possession of, often enviously.
caucus: A usually preliminary meeting of party members to nominate candidates for public office or delegates to be sent a nominating convention, or to confer regarding policy.
extol: To praise; to make high.
arboreal: Any tree-dwelling creature.
philosophical: Of, or pertaining to, philosophy.
novel: Newly made, formed or evolved; having no precedent; of recent origin; new.
lancet: A sharp, pointed, two-edged surgical instrument used in venesection and for opening abscesses etc.
scientific: Of, or having to do with science.
profligate: An abandoned person; one openly and shamelessly vicious; a dissolute person.
glacier: A large body of ice which flows under its own mass, usually downhill.
archaic: (usually capitalized) A general term for the prehistoric period intermediate between the earliest period (‘Paleo-Indian’, ‘Paleo-American’, ‘American‐paleolithic’, &c.) of human presence in the Western Hemisphere, and the most recent prehistoric period (‘Woodland’, etc.).
fractious: Given to troublemaking.
anarchist: One who believes in or advocates the absence of hierarchy and authority in most forms (compare anarchism), especially one who works toward the realization of such.
swerve: A sudden movement out of a straight line, for example to avoid a collision.
lacerate: To tear, rip or wound.
abut: To touch by means of a mutual border, edge or end; to border on; to lie adjacent (to); to be contiguous (said of an area of land)
credulous: Excessively ready to believe things; gullible.
permeate: A watery by-product of milk production.
extraneous: Not belonging to, or dependent upon, a thing; without or beyond a thing; foreign
archetypal: Of or pertaining to an archetype.
furnish: Material used to create an engineered product.
grove: A small forest.
ramify: To divide into branches or subdivisions.
seize: To deliberately take hold of; to grab or capture.
promulgate: To make known or public.
global: A globally scoped identifier.
archetype: An original model of which all other similar concepts, objects, or persons are merely copied, derivative, emulated, or patterned; a prototype.
pummel: The upper front brow of a saddle.
jaded: To tire, weary or fatigue
gird: To bind with a flexible rope or cord.
purloin: To take the property of another, often in breach of trust; to appropriate wrongfully; to steal.
congeal: To change from a liquid to solid state perhaps by cold
extrapolate: To infer by extending known information.
propitious: Favorable; benevolent.
credence: Acceptance of a belief or claim as true, especially on the basis of evidence.
bashful: Shy; not liking to be noticed; socially timid.
compel: To drive together, round up
frustrate: To disappoint or defeat; to vex by depriving of something expected or desired.
gainsay: To say something in contradiction to.
shriek: A sharp, shrill outcry or scream; a shrill wild cry such as is caused by sudden or extreme terror, pain, or the like.
proscribe: To forbid or prohibit.
gnaw: To bite something persistently, especially something tough.
ardent: Full of ardor; fervent, passionate.
manumit: To release from slavery, to free.
writhe: A contortion.
betrothed: To promise to give in marriage.
sable: A small carnivorous mammal of the Old World that resembles a weasel, Martes zibellina, from cold regions in Eurasia and the North Pacific islands, valued for its dark brown fur (Wikipedia).
pilfer: To steal in small quantities, or articles of small value; to practise petty theft.
extricate: To free, disengage, loosen, or untangle.
salient: An outwardly projecting part of a fortification, trench system, or line of defense.
criterion: A standard or test by which individual things or people may be compared and judged.
bereft: To deprive by or as if by violence; to rob; to strip; to benim.
venture: A risky or daring undertaking or journey.
illustrious: Admired, distinguished, respected, or well-known, especially due to past achievements or noble qualities.
signal: A sequence of states representing an encoded message in a communication channel.
polity: An organizational structure of the government of a state, church, etc.
protean: Of or relating to Proteus
desert: (usually in the plural) That which is deserved or merited; a just punishment or reward
arduous: Needing or using up much energy; testing powers of endurance.
unexceptionable: Beyond reproach; unimpeachable
vernal: Pertaining to or occurring in spring.
prospective: The scene before or around, in time or in space; view; prospect.
balm: Any of various aromatic resins exuded from certain plants, especially trees of the genus Commiphora of Africa, Arabia and India and Myroxylon of South America.
malcontent: A person who is not satisfied with current conditions; a discontented person, a rebel.
fabrication: The act of fabricating, framing, or constructing; construction; manufacture
propitiate: To conciliate, appease, or make peace with someone, particularly a god or spirit.
cryptic: A cryptic crossword.
blandishment: Flattering speech or actions designed to persuade or influence.
temper: A tendency to be in a certain type of mood; a habitual way of thinking, behaving or reacting.
device: Any piece of equipment made for a particular purpose, especially a mechanical or electrical one.
skeleton: The system that provides support to an organism, internal and made up of bones and cartilage in vertebrates, external in some other animals.
indemnify: To secure against loss or damage; to insure.
prurient: Uneasy with desire; itching; especially, having a lascivious anxiety or propensity; lustful.
dessert: A sweet confection served as the last course of a meal
artifice: A crafty but underhanded deception.
triumvirate: An official group of three people, especially a ruling council of three men and particularly two such councils in Roman history.
caper: A playful leap or jump.
advert: An advertisement, an ad.
harry: To plunder, pillage, assault.
sublimate: A product obtained by sublimation.
facile: Easy, now especially in a disparaging sense; contemptibly easy.
excise: A tax charged on goods produced within the country (as opposed to customs duties, charged on goods from outside the country).
culinary: Relating to the practice of cookery or the activity of cooking.
bilk: The spoiling of someone's score in the crib.
bent: To cause (something) to change its shape into a curve, by physical force, chemical action, or any other means.
pomp: Show of magnificence; parade; display; power.
slaughter: The killing of animals, generally for food.
ingratiate: To bring oneself into favour with someone by flattering or trying to please him or her.
pugnacious: Naturally aggressive or hostile; combative; belligerent; bellicose.
design: A specification of an object or process, referring to requirements to be satisfied and thus conditions to be met for them to solve a problem.
ascendency: The process or period of one's ascent
sybarite: A person devoted to pleasure and luxury.
peremptory: A challenge to the admission of a juror, without the challenger needing to show good cause.
debauch: An individual act of debauchery.
faction: A group of people, especially within a political organization, which expresses a shared belief or opinion different from people who are not part of the group.
betoken: To signify by some visible object; show by signs or tokens.
bombastic: (of a person, their language or writing) showy in speech and given to using flowery or elaborate terms; grandiloquent; pompous
culminate: Of a heavenly body, to be at the highest point, reach its greatest altitude.
intimate: A very close friend.
declivity: The downward slope of a hill; the downward slope of a curve.
punctilious: Strictly attentive to detail; meticulous or fastidious, particularly to codes or conventions.
impart: To give or bestow (e.g. a quality or property).
detective: (law enforcement) A police officer who looks for evidence as part of solving a crime; an investigator.
ascetic: One who is devoted to the practice of self-denial, either through seclusion or stringent abstinence.
society: A long-standing group of people sharing cultural aspects such as language, dress, norms of behavior and artistic forms.
magisterial: Befitting the status or skill of a magister or master; authoritative, masterly.
overbearing: To carry over.
rudiment: (often in the plural) A fundamental principle or skill, especially in a field of learning.
smug: To make smug, or spruce.
farcical: Resembling a farce; ludicrous; absurd.
lineament: Any distinctive shape or line, etc.
palatable: Pleasing to the taste, tasty.
culpable: Meriting condemnation, censure or blame, especially as something wrong, harmful or injurious; blameworthy.
calumny: A false accusation or charge brought to tarnish another's reputation or standing.
undertake: To take upon oneself; to start, to embark on (a specific task etc.).
importunate: (of a demand) Persistent or pressing, often annoyingly so.
quixotic: Possessing or acting with the desire to do noble and romantic deeds, without thought of realism and practicality; exceedingly idealistic.
spectacular: A spectacular display.
digest: To distribute or arrange methodically; to work over and classify; to reduce to portions for ready use or application.
propriety: The particular character or essence of someone or something; individuality.
assiduous: Hard-working, diligent or regular (in attendance or work); industrious.
roseate: Like the rose flower; pink; rosy.
supercilious: Arrogantly superior; showing contemptuous indifference; haughty.
halting: To limp; move with a limping gait.
fastidious: Excessively particular, demanding, or fussy about details, especially about tidiness and cleanliness.
lurch: A sudden or unsteady movement.
firebrand: An argumentative troublemaker or revolutionary; one who agitates against the current situation.
upbraid: The act of reproaching; scorn; disdain.
camaraderie: Close friendship in a group of friends or teammates.
cursory: Hasty; superficial; careless
quandary: A state of not knowing what to decide; a state of difficulty or perplexity; a state of uncertainty, hesitation or puzzlement.
passe: To change place.
obloquy: Abusive language.
disappear: To vanish.
assimilate: Something that is or has been assimilated.
majority: More than half (50%) of some group.
proceeds: To move, pass, or go forward or onward; to advance; to carry on
submarine: A boat that can go underwater.
cameo: A piece of jewelry, etc., carved in relief.
ignominy: Great dishonor, shame, or humiliation.
clout: Influence or effectiveness, especially political.
fiasco: A sudden or unexpected failure.
renegade: An outlaw or rebel.
carouse: A large draught of liquor.
curtailment: The act of curtailing
hoodwink: To deceive by disguise; to dupe, bewile, mislead.
assuage: To lessen the intensity of, to mitigate or relieve (hunger, emotion, pain etc.).
recalcitrant: A person who is recalcitrant.
whittle: A knife; especially, a pocket knife, sheath knife, or clasp knife.
subside: To sink or fall to the bottom; to settle, as lees.
disappointed: To sadden or displease (someone) by underperforming, or by not delivering something promised or hoped for.
fathom: Grasp, envelopment, control.
assert: An assertion; a section of source code which tests whether an expected condition is true.
vehemence: An intense concentration, force or power.
fatuous: Obnoxiously stupid, vacantly silly, content in one's foolishness.
ideology: Doctrine, philosophy, body of beliefs or principles belonging to an individual or group.
foolhardy: Marked by unthinking recklessness with disregard for danger; boldly rash; hotheaded.
cynic: A person who believes that all people are motivated by selfishness.
chary: In a chary manner.
astute: Quickly and critically discerning.
repine: To fail; to wane.
striate: To mark something with striations.
hoary: White, whitish, or greyish-white.
carp: Any of various freshwater fish of the family Cyprinidae, especially the common carp, Cyprinus carpio.
relegate: Exile, banish, remove, or send away.
success: The achievement of one's aim or goal.
discover: To find or learn something for the first time.
crew: To make the shrill sound characteristic of a rooster; to make a sound in this manner, either in gaiety, joy, pleasure, or defiance.
objective: A material object that physically exists.
bandy: To give and receive reciprocally; to exchange.
fauna: Animals considered as a group; especially those of a particular country, region, time.
pallid: Appearing weak, pale or wan.
daunt: To discourage, intimidate.
retrench: To dig or redig a trench where one already exists.
palliate: To relieve the symptoms of; to ameliorate.
arrogate: To appropriate or lay claim to something for oneself without right.
flay: A fright; a scare.
attrition: Wearing or grinding down by friction.
cavort: (originally intransitive) To prance, said of mounts
pedantic: Like a pedant, overly concerned with formal rules and trivial points of learning.
suitable: Having sufficient or the required properties for a certain purpose or task; appropriate to a certain occasion.
reprieve: The cancellation or postponement of a punishment.
drought: A period of unusually low rainfall, longer and more severe than a dry spell.
clad: (past tense clad) To clothe.
chamber: A room or set of rooms, particularly:
portentous: Of momentous or ominous significance.
fecund: Highly fertile; able to produce offspring.
obtrude: To proffer (something) by force; to impose (something) on someone or into some area.
ulterior: Situated beyond, or on the farther side.
dearth: A period or condition when food is rare and hence expensive; famine.
embark: To get on a boat or ship or (outside the USA) an aeroplane.
audacity: Insolent boldness, especially when imprudent or unconventional.
larder: A cool room in a domestic house where food is stored, but larger than a pantry.
rarefied: Distant from the lives and everyday concerns of ordinary people; esoteric, exclusive, select.
troth: An oath, pledge, or promise.
clamor: A great outcry or vociferation; loud and continued shouting or exclamation.
reprobate: One rejected by God; a sinful person.
enormous: Deviating from the norm; unusual, extraordinary.
summon: Call, command, order
partisan: An adherent to a party or faction.
humble: (Baltimore) An arrest based on weak evidence intended to demean or punish the subject.
felicity: Happiness.
spate: A river flood; an overflow or inundation.
audacious: Showing willingness to take bold risks; recklessly daring.
equable: Unvarying, calm and steady; constant and uniform.
atrophy: A reduction in the functionality of an organ caused by disease, injury or lack of use.
debacle: An event or enterprise that ends suddenly and disastrously, often with humiliating consequences.
threadbare: (of cloth) shabby, frayed and worn to an extent that warp threads show
credo: A belief system.
augment: (grammar) In some Indo-European languages, a prefix e- (a- in Sanskrit) indicating a past tense of a verb.
encroachment: An entry into a place or area that was previously uncommon; an advance beyond former borders; intrusion; incursion.
cobbler: A person who makes and repairs shoes
rescind: To repeal, annul, or declare void; to take (something such as a rule or contract) out of effect.
ensure: To make a pledge to (someone); to promise, guarantee (someone of something); to assure.
talon: A sharp, hooked claw of a bird of prey or other predatory animal.
venerable: Commanding respect because of age, dignity, character or position.
fervor: An intense, heated emotion; passion, ardor.
epitomize: To make an epitome of; to shorten; to condense.
scheme: A systematic plan of future action.
ford: A location where a stream is shallow and the bottom has good footing, making it possible to cross from one side to the other with no bridge, by walking, riding, or driving through the water; a crossing.
inured: To cause someone to become accustomed to something (usually) unpleasant.
debauchery: Indulgence in sensual pleasures; scandalous activities involving sex, alcohol, or drugs without inhibition.
anemic: An individual who has anemia.
episode: An incident, action, or time period standing out by itself, but more or less connected with a complete series of events.
superannuated: To retire or put out of use due to age.
requisition: A formal request for something.
armada: A fleet of warships, especially with reference to the Spanish Armada.
auspicious: Of good omen; indicating future success.
technique: The practical aspects of a given art, occupation etc.; formal requirements.
complement: A protective substance that exists in the serum or other bodily fluid and is capable of killing microorganisms; complement.
restrained: To control or keep in check.
grisly: Horrifyingly repellent; gruesome, terrifying.
fetter: A chain or similar object used to bind a person or animal – often by its legs (usually in plural).
dire: Warning of bad consequences: ill-boding; portentous.
repast: A meal.
unmitigated: Not mitigated.
keen: To make cold, to sharpen.
debilitate: To make feeble; to weaken.
stammer: The involuntary repetition of a sound in speech.
impolitic: Not in accordance with good policy.
esteem: Favourable regard.
rife: Widespread, common, prevalent, current (mainly of unpleasant or harmful things).
temperature: A measure of cold or heat, often measurable with a thermometer.
austere: Grim or severe in manner or appearance
succor: Aid, assistance, or relief given to one in distress; ministration.
besiege: To beset or surround with armed forces for the purpose of compelling to surrender, to lay siege to, beleaguer.
compunction: A pricking of conscience or a feeling of regret, especially one which is slight or fleeting.
untoward: Unfavourable, adverse, or disadvantageous.
fidelity: Faithfulness to one's duties.
pore: A tiny opening in the skin.
stint: A period of time spent doing or being something; a spell.
concomitant: Something happening or existing at the same time.
aspersion: An attack on somebody's reputation or good name, often in the phrase to cast aspersions upon….
liberal: One with liberal views, supporting individual liberty (see Wikipedia's article on Liberalism).
decadent: A person affected by moral decay.
sanctimonious: Making a show of being morally better than others, especially hypocritically pious.
exert: To put in vigorous action.
quaver: A trembling shake.
autocratic: Of or pertaining to autocracy or to an autocrat; absolute; holding independent and arbitrary powers of government.
tension: The condition of being held in a state between two or more forces, which are acting in opposition to each other.
imperturbable: Not easily perturbed, upset or excited.
manifestation: The act or process of becoming manifest.
conduit: A pipe or channel for conveying water etc.
idiosyncrasy: A behavior or way of thinking that is characteristic of a person.
figuratively: (manner) In a figurative manner.
fickle: Quick to change one’s opinion or allegiance; insincere; not loyal or reliable.
cozen: To become cozy; (by extension) to become acquainted, comfortable, or familiar with.
fresco: A cool, refreshing state of the air; coolness, duskiness, shade.
poignancy: The quality of being poignant
decimate: A tithe or other 10% tax or payment.
despair: Loss of hope; utter hopelessness; complete despondency.
sanguine: Blood colour; red.
secular: A secular ecclesiastic, or one not bound by monastic rules.
tentacle: An elongated, boneless, flexible organ or limb of some animals, such as the octopus and squid.
expensive: Given to expending a lot of money; profligate, lavish.
autonomous: Self-governing. Intelligent, sentient, self-aware, thinking, feeling, governing independently.
irresolute: Undecided or unsure how to act
rebuke: A harsh criticism.
conflagration: A large fire extending to many objects, or over a large space; a general burning.
quip: A smart, sarcastic turn or jest; a taunt; a severe retort or comeback; a gibe.
finesse: Skill in the handling or manipulation of a situation.
vitriolic: Of or pertaining to vitriol; derived from or resembling vitriol.
dutiful: Accepting of one's legal or moral obligations and willing to do them well, and without complaint.
phlegmatic: One who has a phlegmatic disposition.
stilted: To raise on stilts, or as if on stilts
decorous: Marked by proper behavior.
tide: The periodic change of the sea level, particularly when caused by the gravitational influence of the sun and the moon.
scurrilous: (of a person) Given to vulgar verbal abuse; foul-mouthed.
adjudicate: To settle a legal case or other dispute.
terrace: A platform that extends outwards from a building.
experience: The effect upon the judgment or feelings produced by any event, whether witnessed or participated in; personal and direct impressions as contrasted with description or fancies; personal acquaintance; actual enjoyment or suffering.
avarice: Excessive or inordinate desire of gain; greed for wealth
unseemly: Inconsistent with established standards of good form or taste.
insurgent: One of several people who take up arms against the local state authority; a participant in insurgency.
stanch: That which stanches or checks a flow.
flagrant: Obvious and offensive; blatant; scandalous.
parity: Equality; comparability of strength or intensity.
quell: A subduing.
dormer: A room-like, roofed projection from a sloping roof
provender: Food, especially for livestock.
deduce: To reach a conclusion by applying rules of logic to given premises.
attitude: The position of the body or way of carrying oneself.
semaphore: Any equipment used for visual signalling by means of flags, lights, or mechanically moving arms, which are used to represent letters of the alphabet, or words.
temporize: To deliberately act evasively or prolong a discussion in order to gain time or postpone a decision, sometimes in order to reach a compromise or simply to make a conversation more temperate; to stall for time.
territory: A large extent or tract of land; for example a region, country or district.
extremely: (degree) To an extreme degree.
avow: Avowal
accentuate: To pronounce with an accent or vocal stress.
rhetoric: The art of using language, especially public speaking, as a means to persuade.
connive: Often followed by with: to secretly cooperate with another person or persons in order to commit a crime or other wrongdoing; to collude, to conspire.
flaunt: Anything displayed for show.
incongruity: The state of being incongruous, or lacking congruence.
interminable: A repeating decimal.
jibe: A facetious or insulting remark; a jeer, a taunt.
pontifical: A book containing the offices, or formulas, used by a pontiff.
defame: Disgrace, dishonour.
jocund: Jovial; exuberant; lighthearted; merry and in high spirits; exhibiting happiness.
canard: A false or misleading report or story, especially if deliberately so.
justify: To provide an acceptable explanation for.
serendipity: A combination of events which have come together by chance to make a surprisingly good or wonderful outcome.
remorse: A feeling of regret or sadness for doing wrong or sinning.
graphic: A drawing or picture.
avuncular: In the manner of an uncle, pertaining to an uncle.
divulge: To make public or known; to communicate to the public; to tell (information, especially a secret) so that it may become generally known
consign: To transfer to the custody of, usually for sale, transport, or safekeeping.
scrupulous: Exactly and carefully conducted.
perfidious: Of, pertaining to, or representing perfidy; disloyal to what should command one's fidelity or allegiance.
flout: The act by which something is flouted; violation of a law.
retinue: A group of servants or attendants, especially of someone considered important.
pillage: The spoils of war.
deference: Great respect.
procedural: A type of literature, film, or television program involving a sequence of technical detail.
disport: Anything which diverts one from serious matters; a game, a pastime, a sport.
giddy: To make dizzy or unsteady.
sobriety: The quality or state of being sober.
flag: A piece of cloth, often decorated with an emblem, used as a visual signal or symbol.
replenish: To refill; to renew; to supply again or to add a fresh quantity to.
haphazard: Random; chaotic; incomplete; not thorough, constant, or consistent.
awry: Turned or twisted toward one side; crooked, distorted, out of place; wry.
brawn: Strong muscles or lean flesh, especially of the arm, leg or thumb.
constituent: A part, or component of a wholemerit: A claim to commendation or a reward.
corroborate: To confirm or support something with additional evidence; to attest or vouch for.
dispatch: A message sent quickly, as a shipment, a prompt settlement of a business, or an important official message sent by a diplomat, or military officer.
haste: Speed; swiftness; dispatch.
burnish: Polish; lustre.
ratify: To give formal consent to; make officially valid, sign off on.
foreboding: To predict a future event; to hint at something that will happen (especially as a literary device).
require: To ask (someone) for something; to request.
manifest: A list or invoice of the passengers or goods being carried by a commercial vehicle or ship.
definitive: (grammar) a word, such as a definite article or demonstrative pronoun, that defines or limits something
amenable: Willing to respond to persuasion or suggestions.
detritus: (chiefly geological) Pieces of rock broken off by ice, glacier, or erosion.
foment: Fomentation.
axiom: A seemingly self-evident or necessary truth which is based on assumption; a principle or proposition which cannot actually be proved or disproved.
platitude: An often-quoted saying that is supposed to be meaningful but has become unoriginal or hackneyed through overuse; a cliché.
haul: An act of hauling or pulling, particularly with force; a (violent) pull or tug.
palpitate: To beat strongly or rapidly; said especially of the heart.
stump: The remains of something that has been cut off; especially the remains of a tree, the remains of a limb.
rend: A violent separation of parts.
resource: Something that one uses to achieve an objective, e.g. raw materials or personnel.
contentious: Marked by heated arguments or controversy.
notion: Mental apprehension of whatever may be known, thought, or imagined; idea, concept.
solicitous: Disposed to solicit; eager to obtain something desirable, or to avoid anything evil.
subsidy: Financial support or assistance, such as a grant.
degenerate: One who is degenerate, who has fallen from previous stature; an immoral person.
meander: A decorative border constructed from a continuous line, shaped into a repeated motif, that is commonly found in Greek art.
forbear: To keep away from; to avoid; to abstain from.
banal: Common in a boring way, to the point of being predictable; containing nothing new or fresh.
delve: To dig the ground, especially with a shovel.
healthy: Enjoying health and vigor of body, mind, or spirit: well.
promiscuous: Made up of various disparate elements mixed together; of disorderly composition.
rakish: Dashingly, carelessly, or sportingly unconventional or stylish; jaunty; characterized by a devil-may-care unconventionality; having a somewhat disreputable quality or appearance.
imposing: To establish or apply by authority.
responsible: The individual who bears the responsibility for something.
livelihood: A means of providing the necessities of life for oneself (for example, a job or income).
contravene: To act contrary to an order; to fail to conform to a regulation or obligation.
solipsism: The theory that the self is all that exists or that can be proven to exist.
scale: A ladder; a series of steps; a means of ascending.
hegemony: Domination, influence, or authority over another, especially by one political group over a society or by one nation over others.
apologist: One who makes an apology.
deleterious: Harmful often in a subtle or unexpected way.
vicarious: Delegated.
forgo: To let pass, to leave alone, to let go.
bane: A cause of misery or death.
skittish: Easily scared or startled; timid.
flotilla: A small fleet of warships (usually of the same class), or a fleet of small ships.
extenuate: To lessen; to palliate; to lessen or weaken the force of; to diminish the conception of, as crime, guilt, faults, ills, accusations, etc.
wistful: Full of longing or yearning.
rhyme: Rhyming verse (poetic form)
heir: Someone who inherits, or is designated to inherit, the property of another.
deign: To condescend; to do despite a perceived affront to one's dignity.
corpulence: The state or characteristic of being corpulent.
spurious: False, not authentic, not genuine.
persist: To go on stubbornly or resolutely.
agitated: To disturb or excite; to perturb or stir up (a person).
abeyance: Expectancy; condition of ownership of real property being undetermined; lapse in succession of ownership of estate, or title.
forsake: To abandon, to give up, to leave (permanently), to renounce.
delineate: To sketch out, draw or trace an outline.
capitulate: To surrender; to end all resistance, to give up; to go along with or comply.
peroration: The concluding section of a discourse, either written or oral, in which the orator or writer sums up and commends his topic to his audience, particularly as used in the technical sense of a component of ancient Roman oratorical delivery.
bastion: A projecting part of a rampart or other fortification.
invective: An expression which inveighs or rails against a person.
polemic: A person who writes in support of one opinion, doctrine, or system, in opposition to another; one skilled in polemics; a controversialist; a disputant.
ridiculous: Deserving of ridicule; foolish; absurd.
mortify: To discipline (one's body, appetites etc.) by suppressing desires; to practise abstinence on.
herd: A number of domestic animals assembled together under the watch or ownership of a keeper.
stupendous: Astonishingly great or large; huge; enormous.
debunk: To discredit, or expose to ridicule the falsehood or the exaggerated claims of something.
stolid: Having or revealing little emotion or sensibility; dully or heavily stupid.
contempt: The state or act of contemning; the feeling or attitude of regarding someone or something as inferior, base, or worthless; scorn, disdain.
tact: The sense of touch; feeling.
enclave: A political, cultural or social entity or part thereof that is completely surrounded by another.
fortuitous: Happening by chance; coincidental, accidental.
delude: To deceive into believing something which is false; to lead into error; to dupe.
proselytize: To advertise one’s religious beliefs; to convert (someone) to one’s own faith or religious movement or encourage them to do so.
nonentity: An unimportant or insignificant person
beget: To father; to sire; to produce (a child).
hermitage: A house or dwelling where a hermit lives.
enrapture: To fill with great delight or joy; to fascinate or captivate.
rogue: A scoundrel, rascal or unprincipled, deceitful, and unreliable person.
ripple: A moving disturbance, or undulation, in the surface of a fluid.
hesitate: To stop or pause respecting decision or action; to be in suspense or uncertainty as to a determination.
swarthy: A swarthy person.
improvident: Failing to provide for the future; reckless
defunct: The dead person (referred to).
deluge: A great flood or rain.
foible: A quirk, idiosyncrasy, or mannerism; unusual habit or way (usage is typically plural), that is slightly strange or silly.
chaff: The inedible parts of a grain-producing plant.
founder: One who founds or establishes (especially said of a company, project, organisation, state)
contingent: An event which may or may not happen; that which is unforeseen, undetermined, or dependent on something future.
tour: A journey through a particular building, estate, country, etc.
abstemious: Refraining from freely consuming food or strong drink; sparing in diet; abstinent, temperate.
belabor: To labour about; labour over; work hard upon; ply diligently.
despoil: Plunder; spoliation.
virtuoso: An expert in virtù or art objects and antiquities; a connoisseur.
surrounded: To encircle something or simultaneously extend in all directions.
hilarious: Very funny; causing great merriment and laughter.
premise: A proposition antecedently supposed or proved; something previously stated or assumed as the basis of further argument; a condition; a supposition.
tangential: Referring to a tangent, moving at a tangent to something.
disquisition: A methodical inquiry or investigation.
denigrate: To criticise so as to besmirch; traduce, disparage or defame.
demagogue: A political orator or leader who gains favor by pandering to or exciting the passions and prejudices of the audience rather than by using rational argument.
innate: To cause to exist; to call into being.
impeccable: Perfect, without faults, flaws or errors
flounder: A European species of flatfish having dull brown colouring with reddish-brown blotches; fluke, European flounder, Platichthys flesus.
testy: Easily annoyed, irritable.
plead: To present (an argument or a plea), especially in a legal case.
viscid: Viscous; having a high viscosity.
beleaguering: To besiege; to surround with troops.
glower: An angry glare or stare.
hoarse: Having a dry, harsh tone to the voice, as a result of a sore throat, age, emotion, etc.
sully: A blemish.
caprice: An impulsive, seemingly unmotivated action, change of mind, or notion.
tome: One in a series of volumes.
survive: Of a person, to continue to live; to remain alive.
placate: To calm; to bring peace to; to influence someone who was furious to the point that they become content or at least no longer irate.
derivative: Something derived.
denizen: An inhabitant of a place; one who dwells in.
reverie: A state of dreaming while awake; a loose or irregular train of thought; musing or meditation; daydream.
ravenous: Very hungry.
fraternal: A society formed to provide mutual aid, such as insurance.
ecumenical: Pertaining to the universal Church, representing the entire Christian world; interdenominational; sometimes by extension, interreligious.
mode: One of several ancient Greek scales.
doggerel: A comic or humorous verse, usually irregular in measure.
belie: To lie around; encompass.
mundane: An unremarkable, ordinary human being.
honest: To adorn or grace; to honour; to make becoming, appropriate, or honourable.
malevolent: Having or displaying ill will; wishing harm on others
muster: Gathering.
toady: A sycophant who flatters others to gain personal advantage or an obsequious lackey or minion
treasure: A collection of valuable things; accumulated wealth; a stock of money, jewels, etc.
redolent: Fragrant or aromatic; having a sweet scent.
diaphanous: Transparent or translucent; allowing light to pass through; capable of being seen through.
depravity: The state or condition of being depraved; moral debasement.
wrangle: An act of wrangling.
frenetic: One who is frenetic.
enjoin: To lay upon, as an order or command; to give an injunction to; to direct with authority; to order; to charge.
distinction: That which distinguishes; a single occurrence of a determining factor or feature, the fact of being divided; separation, discrimination.
sleight: Cunning; craft; artful practice.
incorrigible: An incorrigibly bad individual.
belittle: To knowingly say that something is smaller or less important than it actually is, especially as a way of showing contempt or deprecation.
illegal: An illegal act or technique.
irksome: Marked by irritation or annoyance; disagreeable; troublesome by reason of long continuance or repetition
accede: To approach; to arrive, to come forward.
torpid: (Oxford University slang) An inferior racing boat, or one who rows in such a boat.
uncomfortable: Not comfortable; causing discomfort.
gusty: (of wind) Blowing in gusts; blustery; tempestuous.
dirge: A mournful poem or piece of music composed or performed as a memorial to a dead person.
deprecate: To belittle or express disapproval of.
ostensible: Apparent, evident; meant for open display.
bridle: The headgear with which a horse is directed and which carries a bit and reins.
inclined: To bend or move (something) out of a given plane or direction, often the horizontal or vertical.
rubric: A heading in a book highlighted in red.
frugal: Avoiding unnecessary expenditure either of money or of anything else which is to be used or consumed; avoiding waste.
belligerent: A state or other armed participant in warfare
imagination: The image-making power of the mind; the act of mentally creating or reproducing an object not previously perceived; the ability to create such images.
gist: The most essential part; the main idea or substance (of a longer or more complicated matter); the crux of a matter; the pith.
prattle: Silly, childish talk; babble.
fervent: Exhibiting particular enthusiasm, zeal, conviction, persistence, or belief.
travesty: An absurd or grotesque misrepresentation.
unfortunately: Happening through bad luck, or because of some unfortunate event.
natty: Smart and fashionable.
deride: To harshly mock; ridicule.
attribute: A characteristic or quality of a thing.
plenitude: Fullness; completeness.
craven: A coward.
bemused: To confuse or bewilder.
vociferous: Making or characterized by a noisy outcry; clamorous.
subaltern: A subordinate.
cohere: To stick together physically, by adhesion.
truculent: Cruel or savage.
unique: A thing without a like; something unequalled or unparallelled.
pacifist: One who loves, supports, or favours peace.
oppress: To keep down by unjust force.
rebus: A kind of word puzzle which uses pictures to represent words or parts of words.
vestige: The mark of the foot left on the earth.
benefactor: Somebody who gives a gift, often money to a charity.
purvey: To prepare in advance (for or to do something); to plan, make provision.
tribunal: An assembly including one or more judges to conduct judicial business; a court of law.
turpitude: Inherent baseness, depravity or wickedness; corruptness and evilness.
buxom: Pliant, obedient, tractable (to) (i.e. easily moved or bent, morally).
wizened: To wither; to become, or make, lean and wrinkled by shrinkage, as from age or illness.
benevolent: Having a disposition to do good.
gibe: Alternative spelling of gybe
recovering: To get back, to regain (a physical thing; in astronomy and navigation, sight of a thing or a signal).
benign: Kind; gentle; mild.merit: A claim to commendation or a reward.